CCGGACATTAGGCCCCCCGGCTAC -> CGGACATTAGGCCCCCCGGCTACA
TCCTATTACCTCTGTCAGACACAC -> CCTATTACCTCTGTCAGACACACC
ACACACCGATCCCCTGTTAGGCCC -> CACACCGATCCCCTGTTAGGCCCC
CAGAAAAAAATCTGTGCATAACAC -> AGAAAAAAATCTGTGCATAACACT
CCGTCGGACTGAGGCCTCCATTCC -> CGTCGGACTGAGGCCTCCATTCCC
ACAGTAGTTTCTTTTGCGGAGTGG -> CAGTAGTTTCTTTTGCGGAGTGGA
CGACCTCCACCTGTAAGAAAAGTT -> GACCTCCACCTGTAAGAAAAGTTC
GGCCCTCCTTGGCAAACTCGGGCG -> GCCCTCCTTGGCAAACTCGGGCGT
ATTCACGTTGTAAATCCACTCAGT -> TTCACGTTGTAAATCCACTCAGTA
GCTACAGTAGTTTCTTTTGCGGAG -> CTACAGTAGTTTCTTTTGCGGAGT
GCGACCAGCATTGGGTAACTGTTC -> CGACCAGCATTGGGTAACTGTTCT
TTGTAAATCCACTCAGTATGTATT -> TGTAAATCCACTCAGTATGTATTG
GAACAAAGCAGGAATATGCTGAAA -> AACAAAGCAGGAATATGCTGAAAT
CATCCATGTTGAAAAAAATGAGCG -> ATCCATGTTGAAAAAAATGAGCGT
TGGATTGGTGAATAACACATCAAG -> GGATTGGTGAATAACACATCAAGG
GCAGTAACTGGAGGAAGCGCGCCC -> CAGTAACTGGAGGAAGCGCGCCCT
GCCTCAGGTGCCCTCATCGGCAGA -> CCTCAGGTGCCCTCATCGGCAGAT
CAGTGGGCCCTGTTGTAGGACTGT -> AGTGGGCCCTGTTGTAGGACTGTA
TCGTGGCCACCGACCAGTCAAGAC -> CGTGGCCACCGACCAGTCAAGACT
TGTGTGTTGCTATGGCCCGCTTGC -> GTGTGTTGCTATGGCCCGCTTGCT
CTTTGCACATGTGAAGCCTAGCAT -> TTTGCACATGTGAAGCCTAGCATA
AGCTATGATCATGGCAGTGGGTAG -> GCTATGATCATGGCAGTGGGTAGT
GGACATACACAATGTGTTTTGGTA -> GACATACACAATGTGTTTTGGTAT
ATCTCTGTGACCACGTCATTGCGG -> TCTCTGTGACCACGTCATTGCGGC
GTAGTTTCTTTTGCGGAGTGGATT -> TAGTTTCTTTTGCGGAGTGGATTC
CAGAGTAAGATGGGCACCAACTGT -> AGAGTAAGATGGGCACCAACTGTG
CAAGCAGTGCCAGACTTGACGTCT -> AAGCAGTGCCAGACTTGACGTCTT
TTCAGCCCCTGCGGCTTATAGTGG -> TCAGCCCCTGCGGCTTATAGTGGC
TCACCTTACCAAGCAGTTAGTTAG -> CACCTTACCAAGCAGTTAGTTAGG
CATACTGAAACCCGGGCAGGCGTC -> ATACTGAAACCCGGGCAGGCGTCA
AGAGCCACATACTGAAACCCGGGC -> GAGCCACATACTGAAACCCGGGCA
CACTTCAGTGGGCCCTGTTGTAGG -> ACTTCAGTGGGCCCTGTTGTAGGA
CCGAAGCGATTCCTATTACCTCTG -> CGAAGCGATTCCTATTACCTCTGT
AGTTAGCAACGTAGCCTCTCAAGA -> GTTAGCAACGTAGCCTCTCAAGAT
CACCATTTAGGACTTTGCTACTAG -> ACCATTTAGGACTTTGCTACTAGC
CTATGGCCCGCTTGCTGACGAACG -> TATGGCCCGCTTGCTGACGAACGA
CGTGTTACTCACATCGTGGAGTGG -> GTGTTACTCACATCGTGGAGTGGA
GCCCGGCCCTCCTTGGCAAACTCG -> CCCGGCCCTCCTTGGCAAACTCGG
ATTGGGTAACTGTTCTACGCTGGG -> TTGGGTAACTGTTCTACGCTGGGA
GTAGCCTCTCAAGATACTTATGTC -> TAGCCTCTCAAGATACTTATGTCT
TCCTTGGCAAACTCGGGCGTTCCG -> CCTTGGCAAACTCGGGCGTTCCGG
TCATCGGCTATTTGGTAAGTTGTC -> CATCGGCTATTTGGTAAGTTGTCC
ACCCTGACGAAACACCATTTAGGA -> CCCTGACGAAACACCATTTAGGAC
AGATGCGCCCGAACGCCTAATCAT -> GATGCGCCCGAACGCCTAATCATC
TAAGGTGCGGCAGATGGGAGTGTT -> AAGGTGCGGCAGATGGGAGTGTTA
ATGGGCACCAACTGTGGGTTTAAA -> TGGGCACCAACTGTGGGTTTAAAG
GGCGTCCTCCATAGGAATGCGACG -> GCGTCCTCCATAGGAATGCGACGG
GGCGGTATACGTTTATGCAGCGAC -> GCGGTATACGTTTATGCAGCGACC
GCTACTAGCTTCTCTCTTCATCAG -> CTACTAGCTTCTCTCTTCATCAGT
GATGGGAGTGTTAGCAAGCGCCCA -> ATGGGAGTGTTAGCAAGCGCCCAT
CATGAACGCGGCAAGGGGTTAGAT -> ATGAACGCGGCAAGGGGTTAGATA
TGGAGTGGACTCTTAAAACCTGAC -> GGAGTGGACTCTTAAAACCTGACT
CCCTGCGGCTTATAGTGGCAAGGC -> CCTGCGGCTTATAGTGGCAAGGCT
GATCCCCTGTTAGGCCCCTTTTCA -> ATCCCCTGTTAGGCCCCTTTTCAT
CTAATCATCGGCTATTTGGTAAGT -> TAATCATCGGCTATTTGGTAAGTT
CGAATCTTCACCTCATTCCGTGTT -> GAATCTTCACCTCATTCCGTGTTG
GGGTATGCTTTCCTGTGCGAAGAT -> GGTATGCTTTCCTGTGCGAAGATT
TTGTCATGAACGCGGCAAGGGGTT -> TGTCATGAACGCGGCAAGGGGTTA
AGGACTTTGCTACTAGCTTCTCTC -> GGACTTTGCTACTAGCTTCTCTCT
CAGTAGCACTCAATGTCGGGTATG -> AGTAGCACTCAATGTCGGGTATGA
CATCGGCAGATTGCAAGTCATAGA -> ATCGGCAGATTGCAAGTCATAGAG
GATGAGCTGCAGGGATGCACTTCA -> ATGAGCTGCAGGGATGCACTTCAG
CTTCCAGGAAACTATGCCAGACGG -> TTCCAGGAAACTATGCCAGACGGA
GGATGCTTTCTCGCCGTTTTAAGA -> GATGCTTTCTCGCCGTTTTAAGAC
GTAACTGGAGGAAGCGCGCCCTCA -> TAACTGGAGGAAGCGCGCCCTCAA
AGATTCCTTAATTCAGACCGCCAA -> GATTCCTTAATTCAGACCGCCAAC
GGGAACTAATCCTGCCTTCAGCCC -> GGAACTAATCCTGCCTTCAGCCCC
TGTCCATGGTCTCACATCTGAGTT -> GTCCATGGTCTCACATCTGAGTTA
GCGTGTTACTCACATCGTGGAGTG -> CGTGTTACTCACATCGTGGAGTGG
CAACGGCATAGTCAATTGTATCCC -> AACGGCATAGTCAATTGTATCCCG
GTCACTTTGATCAGAGTAAGATGG -> TCACTTTGATCAGAGTAAGATGGG
AAGTATCTCTGTGACCACGTCATT -> AGTATCTCTGTGACCACGTCATTG
AATTACCGTCTTTGCTCACGAATC -> ATTACCGTCTTTGCTCACGAATCT
TGTTTGGTCGTGGCCACCGACCAG -> GTTTGGTCGTGGCCACCGACCAGT
TGTCTGTTGCTGCAGCCGGACGGC -> GTCTGTTGCTGCAGCCGGACGGCG
CTGACGAACGAATGAAGTGGCAAA -> TGACGAACGAATGAAGTGGCAAAT
TACCTGGTACTGCGCCGTCGGACT -> ACCTGGTACTGCGCCGTCGGACTG
CAAGCGCCCATGGGTCACGTCGGG -> AAGCGCCCATGGGTCACGTCGGGC
CTGTATATCCCCCCTCATGAGTCA -> TGTATATCCCCCCTCATGAGTCAC
CTCTTCATCAGTCCGTACGCCCGA -> TCTTCATCAGTCCGTACGCCCGAC
ATACACCTGAGATGCGCCCGAACG -> TACACCTGAGATGCGCCCGAACGC
CGGGCAGGCGTCATACCGGGGATA -> GGGCAGGCGTCATACCGGGGATAC
CTTGAGTGTAGGCCTGTCACTTTG -> TTGAGTGTAGGCCTGTCACTTTGA
CGTGTTGTCCTGATAGTACGGAAA -> GTGTTGTCCTGATAGTACGGAAAG
GTGTTACTCACATCGTGGAGTGGA -> TGTTACTCACATCGTGGAGTGGAC
AAAGTCGCCGCTTAGAATGCATTC -> AAGTCGCCGCTTAGAATGCATTCA
GGAGTGTTAGCAAGCGCCCATGGG -> GAGTGTTAGCAAGCGCCCATGGGT
ACTACGGGAACTAATCCTGCCTTC -> CTACGGGAACTAATCCTGCCTTCA
TTATGCAGCGACCAGCATTGGGTA -> TATGCAGCGACCAGCATTGGGTAA
AGATTGCAAGTCATAGAGCCACAT -> GATTGCAAGTCATAGAGCCACATA
AAGGCACACGCTTCGGGGACTGGC -> AGGCACACGCTTCGGGGACTGGCT
GAAAAGTTCAGAGGCGGCGGTATA -> AAAAGTTCAGAGGCGGCGGTATAC
GCCCAGTTATCCTTTCCTACAATC -> CCCAGTTATCCTTTCCTACAATCC
TGAGCAACTACCCCATTATTGGGA -> GAGCAACTACCCCATTATTGGGAT
AAATACCCTGACGAAACACCATTT -> AATACCCTGACGAAACACCATTTA
TAATAGTGTAAGAAGTGCAGGCGA -> AATAGTGTAAGAAGTGCAGGCGAG
GCATACGTTTCATCTACAGAAAAA -> CATACGTTTCATCTACAGAAAAAA
TCCGTGTTCTCGGAGTAGCTAGTA -> CCGTGTTCTCGGAGTAGCTAGTAC
ACGGAAAGAAGTTGTCGAGCCTCT -> CGGAAAGAAGTTGTCGAGCCTCTG
AATTGTATCCCGCAAAAATACCCT -> ATTGTATCCCGCAAAAATACCCTG
CTCACATCTGAGTTAGCAACGTAG -> TCACATCTGAGTTAGCAACGTAGC
CCTGCCGAAACATCCATGTTGAAA -> CTGCCGAAACATCCATGTTGAAAA
AGATGGCCGTTACCAAACTTGCCC -> GATGGCCGTTACCAAACTTGCCCG
CTTCGGGGACTGGCTAAGGTCCGA -> TTCGGGGACTGGCTAAGGTCCGAT
AGCAGTTAGTTAGGAGGCTAGGGG -> GCAGTTAGTTAGGAGGCTAGGGGC
TGCAGGCGAGTAAAGATGGCCGTT -> GCAGGCGAGTAAAGATGGCCGTTA
ACTGTATATCCCCCCTCATGAGTC -> CTGTATATCCCCCCTCATGAGTCA
ATGATCATGGCAGTGGGTAGTCTA -> TGATCATGGCAGTGGGTAGTCTAG
TCATCGGCAGATTGCAAGTCATAG -> CATCGGCAGATTGCAAGTCATAGA
TGATCAGAGTAAGATGGGCACCAA -> GATCAGAGTAAGATGGGCACCAAC
TCGCTTCATGGTCTGGATTGGTGA -> CGCTTCATGGTCTGGATTGGTGAA
GACGGACGTCTCATGCAATCTGCC -> ACGGACGTCTCATGCAATCTGCCG
CACGAATCTTCACCTCATTCCGTG -> ACGAATCTTCACCTCATTCCGTGT
ACCGGGACCGGGACTTTGACCGCA -> CCGGGACCGGGACTTTGACCGCAC
TAGCCTCTCAAGATACTTATGTCT -> AGCCTCTCAAGATACTTATGTCTT
TGTTGAAAAAAATGAGCGTGTTAC -> GTTGAAAAAAATGAGCGTGTTACT
TTGATCAGAGTAAGATGGGCACCA -> TGATCAGAGTAAGATGGGCACCAA
AACCTGACTTGAGTGTAGGCCTGT -> ACCTGACTTGAGTGTAGGCCTGTC
TCTCATGCAATCTGCCGTAACAAA -> CTCATGCAATCTGCCGTAACAAAT
GCAGTTGGGTATGCTTTCCTGTGC -> CAGTTGGGTATGCTTTCCTGTGCG
CAGTTAGTTAGGAGGCTAGGGGCA -> AGTTAGTTAGGAGGCTAGGGGCAT
ACACTCTCCCGGACATTAGGCCCC -> CACTCTCCCGGACATTAGGCCCCC
AGCAAGCGCCCATGGGTCACGTCG -> GCAAGCGCCCATGGGTCACGTCGG
CACGCTTCTAACACCCGTGTTCTC -> ACGCTTCTAACACCCGTGTTCTCT
TCCAATTCCAACTGCAGTAACTGG -> CCAATTCCAACTGCAGTAACTGGA
CACCAACTGTGGGTTTAAAGTCGC -> ACCAACTGTGGGTTTAAAGTCGCC
CCAACTGCAGTAACTGGAGGAAGC -> CAACTGCAGTAACTGGAGGAAGCG
TTAGAATGCATTCAGTATACATCT -> TAGAATGCATTCAGTATACATCTT
CAGTTATCCTTTCCTACAATCCTG -> AGTTATCCTTTCCTACAATCCTGA
TCTTACTCCTGTGTGTTGCTATGG -> CTTACTCCTGTGTGTTGCTATGGC
GGTATGACCCAAGAAGACATACAT -> GTATGACCCAAGAAGACATACATT
CATGTGCACTCGGACCGAGCGACC -> ATGTGCACTCGGACCGAGCGACCT
GTATACGTTTATGCAGCGACCAGC -> TATACGTTTATGCAGCGACCAGCA
GAAGCGATTCCTATTACCTCTGTC -> AAGCGATTCCTATTACCTCTGTCA
GTGCGGCAGATGGGAGTGTTAGCA -> TGCGGCAGATGGGAGTGTTAGCAA
ATGGCCGCCCCACGGATCTGGGAT -> TGGCCGCCCCACGGATCTGGGATG
AGGCTAGGGGCATACCACAGACTA -> GGCTAGGGGCATACCACAGACTAT
CTCTTCCAGGAAACTATGCCAGAC -> TCTTCCAGGAAACTATGCCAGACG
TCCTACAATCCTGAGCGGGGGTAC -> CCTACAATCCTGAGCGGGGGTACT
AGTGCAGGCGAGTAAAGATGGCCG -> GTGCAGGCGAGTAAAGATGGCCGT
ACCTGAGATGCGCCCGAACGCCTA -> CCTGAGATGCGCCCGAACGCCTAA
GTCGCTTCATGGTCTGGATTGGTG -> TCGCTTCATGGTCTGGATTGGTGA
AAGATTCCTTAATTCAGACCGCCA -> AGATTCCTTAATTCAGACCGCCAA
TAGGCAGCTCGGAGTGTCTGTTGC -> AGGCAGCTCGGAGTGTCTGTTGCT
AGCGACCTCCACCTGTAAGAAAAG -> GCGACCTCCACCTGTAAGAAAAGT
GCAGGCGAGTAAAGATGGCCGTTA -> CAGGCGAGTAAAGATGGCCGTTAC
CAGCTCGGAGTGTCTGTTGCTGCA -> AGCTCGGAGTGTCTGTTGCTGCAG
TATGTATTGGCCCCAAGCAGTGCC -> ATGTATTGGCCCCAAGCAGTGCCA
ATGCACTTCAGTGGGCCCTGTTGT -> TGCACTTCAGTGGGCCCTGTTGTA
GATCCTGCCGAAACATCCATGTTG -> ATCCTGCCGAAACATCCATGTTGA
TTCCAACTGCAGTAACTGGAGGAA -> TCCAACTGCAGTAACTGGAGGAAG
CCAGTCAAGACTCTAATAGTGTAA -> CAGTCAAGACTCTAATAGTGTAAG
TCTGTTGCTGCAGCCGGACGGCGT -> CTGTTGCTGCAGCCGGACGGCGTC
TTTCTACGGCTCACACAGAGCGAA -> TTCTACGGCTCACACAGAGCGAAG
TCATGCAATCTGCCGTAACAAATC -> CATGCAATCTGCCGTAACAAATCT
TCAGCATTCCGACTACACAGCTAT -> CAGCATTCCGACTACACAGCTATG
GGGATGCTTTCTCGCCGTTTTAAG -> GGATGCTTTCTCGCCGTTTTAAGA
CAAGGCTACAGTAGTTTCTTTTGC -> AAGGCTACAGTAGTTTCTTTTGCG
ATATACGCGATCCTGCCGAAACAT -> TATACGCGATCCTGCCGAAACATC
ATAATTACCGTCTTTGCTCACGAA -> TAATTACCGTCTTTGCTCACGAAT
GTGTTAGCAAGCGCCCATGGGTCA -> TGTTAGCAAGCGCCCATGGGTCAC
CGCTTAGAATGCATTCAGTATACA -> GCTTAGAATGCATTCAGTATACAT
GCCGTTTTAAGACGTAACCCAGAC -> CCGTTTTAAGACGTAACCCAGACC
GATCAGAGTAAGATGGGCACCAAC -> ATCAGAGTAAGATGGGCACCAACT
ACATTAGGCCCCCCGGCTACAGTG -> CATTAGGCCCCCCGGCTACAGTGG
CTTTTCTTTTTGTCATGAACGCGG -> TTTTCTTTTTGTCATGAACGCGGC
ACTCCTGTGTGTTGCTATGGCCCG -> CTCCTGTGTGTTGCTATGGCCCGC
ATTGGCCCCAAGCAGTGCCAGACT -> TTGGCCCCAAGCAGTGCCAGACTT
TGCGGCCGCAGTTGGGTATGCTTT -> GCGGCCGCAGTTGGGTATGCTTTC
TCACGTTGTAAATCCACTCAGTAT -> CACGTTGTAAATCCACTCAGTATG
GAATCTTCACCTCATTCCGTGTTG -> AATCTTCACCTCATTCCGTGTTGT
CCCTACTAACGGCCTCAGGTGCCC -> CCTACTAACGGCCTCAGGTGCCCT
TAACCCAGACCGCCCAGTAGCACT -> AACCCAGACCGCCCAGTAGCACTC
GGAATATGCTGAAATGAAAAGCTG -> GAATATGCTGAAATGAAAAGCTGG
ATCACGGTAACTGCTTACCTGCAT -> TCACGGTAACTGCTTACCTGCATA
TACGTTTCATCTACAGAAAAAAAT -> ACGTTTCATCTACAGAAAAAAATC
ACGTCTTAGACTACGGGAACTAAT -> CGTCTTAGACTACGGGAACTAATC
ACACAATGTGTTTTGGTATCCAGA -> CACAATGTGTTTTGGTATCCAGAC
CTACGCTGGGATCAACACGGATAT -> TACGCTGGGATCAACACGGATATA
GCTTTCCTGTGCGAAGATTCCTTA -> CTTTCCTGTGCGAAGATTCCTTAA
TGCCTTCAGCCCCTGCGGCTTATA -> GCCTTCAGCCCCTGCGGCTTATAG
ACACCTGAGATGCGCCCGAACGCC -> CACCTGAGATGCGCCCGAACGCCT
TCAAGTATCTCTGTGACCACGTCA -> CAAGTATCTCTGTGACCACGTCAT
CCATGTTGAAAAAAATGAGCGTGT -> CATGTTGAAAAAAATGAGCGTGTT
TAACACTCTCCCGGACATTAGGCC -> AACACTCTCCCGGACATTAGGCCC
CTGATAGTACGGAAAGAAGTTGTC -> TGATAGTACGGAAAGAAGTTGTCG
ATTTAGCTTTTCTTTTTGTCATGA -> TTTAGCTTTTCTTTTTGTCATGAA
TTTTCATTTAGCTTTTCTTTTTGT -> TTTCATTTAGCTTTTCTTTTTGTC
CTTGCTGACGAACGAATGAAGTGG -> TTGCTGACGAACGAATGAAGTGGC
AGCCCTACTAACGGCCTCAGGTGC -> GCCCTACTAACGGCCTCAGGTGCC
TGTGACCACGTCATTGCGGCCGCA -> GTGACCACGTCATTGCGGCCGCAG
AAATCACTTGCATCACGGTAACTG -> AATCACTTGCATCACGGTAACTGC
TAACACATCAAGGCACACGCTTCG -> AACACATCAAGGCACACGCTTCGG
TGGCTAAGGTCCGATAAGGTGCGG -> GGCTAAGGTCCGATAAGGTGCGGC
TAGATAATGTCCATGGTCTCACAT -> AGATAATGTCCATGGTCTCACATC
GGAAGCGCGCCCTCAATCAGCATT -> GAAGCGCGCCCTCAATCAGCATTC
TCTGGGATGCTTTCTCGCCGTTTT -> CTGGGATGCTTTCTCGCCGTTTTA
TCAGACCGCCAACCAAACGATGAG -> CAGACCGCCAACCAAACGATGAGC
ACGATGAGCTGCAGGGATGCACTT -> CGATGAGCTGCAGGGATGCACTTC
TCAGCCCCTGCGGCTTATAGTGGC -> CAGCCCCTGCGGCTTATAGTGGCA
CTCCACCTGTAAGAAAAGTTCAGA -> TCCACCTGTAAGAAAAGTTCAGAG
CTCAATGTCGGGTATGACCCAAGA -> TCAATGTCGGGTATGACCCAAGAA
GTGGCAAATCACTTGCATCACGGT -> TGGCAAATCACTTGCATCACGGTA
CTGACGAAACACCATTTAGGACTT -> TGACGAAACACCATTTAGGACTTT
GGTATCCAGACATGTGCACTCGGA -> GTATCCAGACATGTGCACTCGGAC
CCAGACTTGACGTCTTAGACTACG -> CAGACTTGACGTCTTAGACTACGG
GATGGGCACCAACTGTGGGTTTAA -> ATGGGCACCAACTGTGGGTTTAAA
GATTCCTTAATTCAGACCGCCAAC -> ATTCCTTAATTCAGACCGCCAACC
AGTTAGTTAGGAGGCTAGGGGCAT -> GTTAGTTAGGAGGCTAGGGGCATA
GTACTGCGCCGTCGGACTGAGGCC -> TACTGCGCCGTCGGACTGAGGCCT
CGGAGTGTCTGTTGCTGCAGCCGG -> GGAGTGTCTGTTGCTGCAGCCGGA
TACGTTTATGCAGCGACCAGCATT -> ACGTTTATGCAGCGACCAGCATTG
AGGACTGTATATCCCCCCTCATGA -> GGACTGTATATCCCCCCTCATGAG
CGGTCCGAGCTAATGTCGCTTCAT -> GGTCCGAGCTAATGTCGCTTCATG
TCTCGGAGTAGCTAGTACCTGGTA -> CTCGGAGTAGCTAGTACCTGGTAC
AGCCTAGCATACGTTTCATCTACA -> GCCTAGCATACGTTTCATCTACAG
GAAAAGCTGGTCTGTCTTACGACC -> AAAAGCTGGTCTGTCTTACGACCG
GCCCAGTAGCACTCAATGTCGGGT -> CCCAGTAGCACTCAATGTCGGGTA
TCACTTTGATCAGAGTAAGATGGG -> CACTTTGATCAGAGTAAGATGGGC
CGTGGAGTGGACTCTTAAAACCTG -> GTGGAGTGGACTCTTAAAACCTGA
CCGCCCGCGAAGCCCTACTAACGG -> CGCCCGCGAAGCCCTACTAACGGC
TCCGAGCTAATGTCGCTTCATGGT -> CCGAGCTAATGTCGCTTCATGGTC
GAAGATTCCTTAATTCAGACCGCC -> AAGATTCCTTAATTCAGACCGCCA
TCCCTACCGGGACCGGGACTTTGA -> CCCTACCGGGACCGGGACTTTGAC
AGCAACGTAGCCTCTCAAGATACT -> GCAACGTAGCCTCTCAAGATACTT
CGGCCCTCCTTGGCAAACTCGGGC -> GGCCCTCCTTGGCAAACTCGGGCG
CTCGGACCGAGCGACCTCCACCTG -> TCGGACCGAGCGACCTCCACCTGT
ATGTCGGGTATGACCCAAGAAGAC -> TGTCGGGTATGACCCAAGAAGACA
GCTATTTGGTAAGTTGTCCCCGAC -> CTATTTGGTAAGTTGTCCCCGACG
AGGGGTTAGATAATGTCCATGGTC -> GGGGTTAGATAATGTCCATGGTCT
GCGGTATACGTTTATGCAGCGACC -> CGGTATACGTTTATGCAGCGACCA
GGTACATTGCTGTGTTGTTTGGTC -> GTACATTGCTGTGTTGTTTGGTCG
GCGTCATACCGGGGATACACCTGA -> CGTCATACCGGGGATACACCTGAG
TATTGGCCCCAAGCAGTGCCAGAC -> ATTGGCCCCAAGCAGTGCCAGACT
TAAATCCACTCAGTATGTATTGGC -> AAATCCACTCAGTATGTATTGGCC
TTCCAATTCCAACTGCAGTAACTG -> TCCAATTCCAACTGCAGTAACTGG
TACTTATGTCTTACATGGATCAAG -> ACTTATGTCTTACATGGATCAAGT
TTATAGTGGCAAGGCTACAGTAGT -> TATAGTGGCAAGGCTACAGTAGTT
CAATTCCAACTGCAGTAACTGGAG -> AATTCCAACTGCAGTAACTGGAGG
GGTTTAAAGTCGCCGCTTAGAATG -> GTTTAAAGTCGCCGCTTAGAATGC
AGACATACATTCTTTGCACATGTG -> GACATACATTCTTTGCACATGTGA
AGACGTAACCCAGACCGCCCAGTA -> GACGTAACCCAGACCGCCCAGTAG
CTTCACCTCATTCCGTGTTGTCCT -> TTCACCTCATTCCGTGTTGTCCTG
GAAGCCTAGCATACGTTTCATCTA -> AAGCCTAGCATACGTTTCATCTAC
AGAAGACATACATTCTTTGCACAT -> GAAGACATACATTCTTTGCACATG
TTAGCTTTTCTTTTTGTCATGAAC -> TAGCTTTTCTTTTTGTCATGAACG
TCGAGCCTCTGTTGAGGGGTATGG -> CGAGCCTCTGTTGAGGGGTATGGG
CTTTTTAAGCCAGAACATGAACAA -> TTTTTAAGCCAGAACATGAACAAA
TGCACATGTGAAGCCTAGCATACG -> GCACATGTGAAGCCTAGCATACGT
CTTAATTCAGACCGCCAACCAAAC -> TTAATTCAGACCGCCAACCAAACG
AACTTGCCCGGCCCTCCTTGGCAA -> ACTTGCCCGGCCCTCCTTGGCAAA
CATACGTTTCATCTACAGAAAAAA -> ATACGTTTCATCTACAGAAAAAAA
GAGGGGTATGGGCTTTTCTACGGC -> AGGGGTATGGGCTTTTCTACGGCT
CGCGCCCTCAATCAGCATTCCGAC -> GCGCCCTCAATCAGCATTCCGACT
CGGATCTGGGATGCTTTCTCGCCG -> GGATCTGGGATGCTTTCTCGCCGT
GAAGTTCCAATTCCAACTGCAGTA -> AAGTTCCAATTCCAACTGCAGTAA
AGATGGGAGTGTTAGCAAGCGCCC -> GATGGGAGTGTTAGCAAGCGCCCA
AACATCCATGTTGAAAAAAATGAG -> ACATCCATGTTGAAAAAAATGAGC
TAGTCTAGGCAGCTCGGAGTGTCT -> AGTCTAGGCAGCTCGGAGTGTCTG
TCAACACGGATATACGCGATCCTG -> CAACACGGATATACGCGATCCTGC
ATAAGTTGGCACGCTTCTAACACC -> TAAGTTGGCACGCTTCTAACACCC
AACCCGGGCAGGCGTCATACCGGG -> ACCCGGGCAGGCGTCATACCGGGG
CGCCCGAACGCCTAATCATCGGCT -> GCCCGAACGCCTAATCATCGGCTA
AGCTCGGAGTGTCTGTTGCTGCAG -> GCTCGGAGTGTCTGTTGCTGCAGC
AACTATGCCAGACGGACGTCTCAT -> ACTATGCCAGACGGACGTCTCATG
GGGGTATGGGCTTTTCTACGGCTC -> GGGTATGGGCTTTTCTACGGCTCA
CACAGCTATGATCATGGCAGTGGG -> ACAGCTATGATCATGGCAGTGGGT
CGGCATAGTCAATTGTATCCCGCA -> GGCATAGTCAATTGTATCCCGCAA
TGAAGCCTAGCATACGTTTCATCT -> GAAGCCTAGCATACGTTTCATCTA
CAACACGGATATACGCGATCCTGC -> AACACGGATATACGCGATCCTGCC
GCTATGATCATGGCAGTGGGTAGT -> CTATGATCATGGCAGTGGGTAGTC
ATGTATTGGCCCCAAGCAGTGCCA -> TGTATTGGCCCCAAGCAGTGCCAG
GGCGGCGGTATACGTTTATGCAGC -> GCGGCGGTATACGTTTATGCAGCG
TACAATCCTGAGCGGGGGTACTCA -> ACAATCCTGAGCGGGGGTACTCAT
ATTCCTTAATTCAGACCGCCAACC -> TTCCTTAATTCAGACCGCCAACCA
CGGCGTCCTCCATAGGAATGCGAC -> GGCGTCCTCCATAGGAATGCGACG
GTCTGTTGCTGCAGCCGGACGGCG -> TCTGTTGCTGCAGCCGGACGGCGT
AAGACTCTAATAGTGTAAGAAGTG -> AGACTCTAATAGTGTAAGAAGTGC
GTTCAGAGGCGGCGGTATACGTTT -> TTCAGAGGCGGCGGTATACGTTTA
GTCGGACTGAGGCCTCCATTCCCT -> TCGGACTGAGGCCTCCATTCCCTA
GACATACACAATGTGTTTTGGTAT -> ACATACACAATGTGTTTTGGTATC
ACATCTTACTCCTGTGTGTTGCTA -> CATCTTACTCCTGTGTGTTGCTAT
CGAAGTTCCAATTCCAACTGCAGT -> GAAGTTCCAATTCCAACTGCAGTA
ATGCAATCTGCCGTAACAAATCTT -> TGCAATCTGCCGTAACAAATCTTT
GTGTTTTGGTATCCAGACATGTGC -> TGTTTTGGTATCCAGACATGTGCA
AAGCAGTTAGTTAGGAGGCTAGGG -> AGCAGTTAGTTAGGAGGCTAGGGG
CAAGGGGTTAGATAATGTCCATGG -> AAGGGGTTAGATAATGTCCATGGT
ATGTTGAAAAAAATGAGCGTGTTA -> TGTTGAAAAAAATGAGCGTGTTAC
ATGAAAAGCTGGTCTGTCTTACGA -> TGAAAAGCTGGTCTGTCTTACGAC
GTTCTCTTCCAGGAAACTATGCCA -> TTCTCTTCCAGGAAACTATGCCAG
ACAATCCTGAGCGGGGGTACTCAT -> CAATCCTGAGCGGGGGTACTCATA
TCAATTGTATCCCGCAAAAATACC -> CAATTGTATCCCGCAAAAATACCC
ACTGAGGCCTCCATTCCCTAAGGT -> CTGAGGCCTCCATTCCCTAAGGTA
ACGCCTAATCATCGGCTATTTGGT -> CGCCTAATCATCGGCTATTTGGTA
CATTGCGGCCGCAGTTGGGTATGC -> ATTGCGGCCGCAGTTGGGTATGCT
GTGTGTTGCTATGGCCCGCTTGCT -> TGTGTTGCTATGGCCCGCTTGCTG
TTCATGGTCTGGATTGGTGAATAA -> TCATGGTCTGGATTGGTGAATAAC
TGTGTTGTTTGGTCGTGGCCACCG -> GTGTTGTTTGGTCGTGGCCACCGA
GCATAGTCAATTGTATCCCGCAAA -> CATAGTCAATTGTATCCCGCAAAA
CCTACCGGGACCGGGACTTTGACC -> CTACCGGGACCGGGACTTTGACCG
GACCGGCGGTCCGAGCTAATGTCG -> ACCGGCGGTCCGAGCTAATGTCGC
ACACCGATCCCCTGTTAGGCCCCT -> CACCGATCCCCTGTTAGGCCCCTT
GACTTGAGTGTAGGCCTGTCACTT -> ACTTGAGTGTAGGCCTGTCACTTT
CTGTGACCACGTCATTGCGGCCGC -> TGTGACCACGTCATTGCGGCCGCA
TTCTCTCTTCATCAGTCCGTACGC -> TCTCTCTTCATCAGTCCGTACGCC
ATGCCAGACGGACGTCTCATGCAA -> TGCCAGACGGACGTCTCATGCAAT
TGCGCCCGAACGCCTAATCATCGG -> GCGCCCGAACGCCTAATCATCGGC
CCTCTGTTGAGGGGTATGGGCTTT -> CTCTGTTGAGGGGTATGGGCTTTT
CGTTGTAAATCCACTCAGTATGTA -> GTTGTAAATCCACTCAGTATGTAT
TTTTCTACGGCTCACACAGAGCGA -> TTTCTACGGCTCACACAGAGCGAA
TGTTGCTATGGCCCGCTTGCTGAC -> GTTGCTATGGCCCGCTTGCTGACG
ACCTCCACCTGTAAGAAAAGTTCA -> CCTCCACCTGTAAGAAAAGTTCAG
CCGGGCATGTTAAGTCTGTCACCT -> CGGGCATGTTAAGTCTGTCACCTT
GTTGTAAATCCACTCAGTATGTAT -> TTGTAAATCCACTCAGTATGTATT
CTAGGGGCATACCACAGACTATTG -> TAGGGGCATACCACAGACTATTGA
ATCCTGCCTTCAGCCCCTGCGGCT -> TCCTGCCTTCAGCCCCTGCGGCTT
GAGTGTCTGTTGCTGCAGCCGGAC -> AGTGTCTGTTGCTGCAGCCGGACG
CCCCTGTTAGGCCCCTTTTCATTT -> CCCTGTTAGGCCCCTTTTCATTTA
TAATTACCGTCTTTGCTCACGAAT -> AATTACCGTCTTTGCTCACGAATC
TGCTACTAGCTTCTCTCTTCATCA -> GCTACTAGCTTCTCTCTTCATCAG
GTCAGACACACCGATCCCCTGTTA -> TCAGACACACCGATCCCCTGTTAG
CTTCTCTCTTCATCAGTCCGTACG -> TTCTCTCTTCATCAGTCCGTACGC
GGTAACTGCTTACCTGCATAATTA -> GTAACTGCTTACCTGCATAATTAC
CGTTCCGGCCGCCCGCGAAGCCCT -> GTTCCGGCCGCCCGCGAAGCCCTA
GTCGGGCCACCGGGCATGTTAAGT -> TCGGGCCACCGGGCATGTTAAGTC
TAGTTAGGAGGCTAGGGGCATACC -> AGTTAGGAGGCTAGGGGCATACCA
AGACTTGACGTCTTAGACTACGGG -> GACTTGACGTCTTAGACTACGGGA
TTAATTCAGACCGCCAACCAAACG -> TAATTCAGACCGCCAACCAAACGA
ACACGGATATACGCGATCCTGCCG -> CACGGATATACGCGATCCTGCCGA
CCCGCAAAAATACCCTGACGAAAC -> CCGCAAAAATACCCTGACGAAACA
TGTCAGACACACCGATCCCCTGTT -> GTCAGACACACCGATCCCCTGTTA
TGCTATGGCCCGCTTGCTGACGAA -> GCTATGGCCCGCTTGCTGACGAAC
AGGGGTATGGGCTTTTCTACGGCT -> GGGGTATGGGCTTTTCTACGGCTC
GGCGAGTAAAGATGGCCGTTACCA -> GCGAGTAAAGATGGCCGTTACCAA
ACACAGCTATGATCATGGCAGTGG -> CACAGCTATGATCATGGCAGTGGG
CTGCAGGGATGCACTTCAGTGGGC -> TGCAGGGATGCACTTCAGTGGGCC
GGTCTGTCTTACGACCGGCGGTCC -> GTCTGTCTTACGACCGGCGGTCCG
CTGAAACCCGGGCAGGCGTCATAC -> TGAAACCCGGGCAGGCGTCATACC
CTAGCATACGTTTCATCTACAGAA -> TAGCATACGTTTCATCTACAGAAA
TTTCCTACAATCCTGAGCGGGGGT -> TTCCTACAATCCTGAGCGGGGGTA
GAGTTAGCAACGTAGCCTCTCAAG -> AGTTAGCAACGTAGCCTCTCAAGA
GAAACACCATTTAGGACTTTGCTA -> AAACACCATTTAGGACTTTGCTAC
GTGCACTCGGACCGAGCGACCTCC -> TGCACTCGGACCGAGCGACCTCCA
TAGAATGCATTCAGTATACATCTT -> AGAATGCATTCAGTATACATCTTA
CTTCATCAGTCCGTACGCCCGACC -> TTCATCAGTCCGTACGCCCGACCG
GCCTAGCATACGTTTCATCTACAG -> CCTAGCATACGTTTCATCTACAGA
GTCTCACATCTGAGTTAGCAACGT -> TCTCACATCTGAGTTAGCAACGTA
GGCCGCCCGCGAAGCCCTACTAAC -> GCCGCCCGCGAAGCCCTACTAACG
TACGCGATCCTGCCGAAACATCCA -> ACGCGATCCTGCCGAAACATCCAT
TTTTAAGCCAGAACATGAACAAAG -> TTTAAGCCAGAACATGAACAAAGC
CTTACTCCTGTGTGTTGCTATGGC -> TTACTCCTGTGTGTTGCTATGGCC
AATGTCGGGTATGACCCAAGAAGA -> ATGTCGGGTATGACCCAAGAAGAC
AACGCGGCAAGGGGTTAGATAATG -> ACGCGGCAAGGGGTTAGATAATGT
GCCAGAACATGAACAAAGCAGGAA -> CCAGAACATGAACAAAGCAGGAAT
TCCTCCATAGGAATGCGACGGAGC -> CCTCCATAGGAATGCGACGGAGCC
CTTACCAAGCAGTTAGTTAGGAGG -> TTACCAAGCAGTTAGTTAGGAGGC
TTTTCTTTTTGTCATGAACGCGGC -> TTTCTTTTTGTCATGAACGCGGCA
AACACATCAAGGCACACGCTTCGG -> ACACATCAAGGCACACGCTTCGGG
GTAAATCCACTCAGTATGTATTGG -> TAAATCCACTCAGTATGTATTGGC
TTGCTGACGAACGAATGAAGTGGC -> TGCTGACGAACGAATGAAGTGGCA
ATCTGTGCATAACACTCTCCCGGA -> TCTGTGCATAACACTCTCCCGGAC
TTGCCCGGCCCTCCTTGGCAAACT -> TGCCCGGCCCTCCTTGGCAAACTC
GTGCATAACACTCTCCCGGACATT -> TGCATAACACTCTCCCGGACATTA
GTCTGGATTGGTGAATAACACATC -> TCTGGATTGGTGAATAACACATCA
AGCATTCCGACTACACAGCTATGA -> GCATTCCGACTACACAGCTATGAT
GAGCGGGGGTACTCATAAGTTGGC -> AGCGGGGGTACTCATAAGTTGGCA
GTATGTATTGGCCCCAAGCAGTGC -> TATGTATTGGCCCCAAGCAGTGCC
GTATCTCTGTGACCACGTCATTGC -> TATCTCTGTGACCACGTCATTGCG
TGCGCCGTCGGACTGAGGCCTCCA -> GCGCCGTCGGACTGAGGCCTCCAT
CACATCTGAGTTAGCAACGTAGCC -> ACATCTGAGTTAGCAACGTAGCCT
ACGAACGAATGAAGTGGCAAATCA -> CGAACGAATGAAGTGGCAAATCAC
ATGCGCCCGAACGCCTAATCATCG -> TGCGCCCGAACGCCTAATCATCGG
CGGACCGAGCGACCTCCACCTGTA -> GGACCGAGCGACCTCCACCTGTAA
TGCTTTCCTGTGCGAAGATTCCTT -> GCTTTCCTGTGCGAAGATTCCTTA
AGGTGCCCTCATCGGCAGATTGCA -> GGTGCCCTCATCGGCAGATTGCAA
GGGGATACACCTGAGATGCGCCCG -> GGGATACACCTGAGATGCGCCCGA
GTGTTGCTATGGCCCGCTTGCTGA -> TGTTGCTATGGCCCGCTTGCTGAC
GGAAAGAAGTTGTCGAGCCTCTGT -> GAAAGAAGTTGTCGAGCCTCTGTT
CTAGTACCTGGTACTGCGCCGTCG -> TAGTACCTGGTACTGCGCCGTCGG
AATCCTGCCTTCAGCCCCTGCGGC -> ATCCTGCCTTCAGCCCCTGCGGCT
TAGGACTGTATATCCCCCCTCATG -> AGGACTGTATATCCCCCCTCATGA
GTTGTCCCCGACGGACATACACAA -> TTGTCCCCGACGGACATACACAAT
GATTGGTGAATAACACATCAAGGC -> ATTGGTGAATAACACATCAAGGCA
ACACAGAGCGAAGTTCCAATTCCA -> CACAGAGCGAAGTTCCAATTCCAA
CGGCGGTCCGAGCTAATGTCGCTT -> GGCGGTCCGAGCTAATGTCGCTTC
AAGCCCTACTAACGGCCTCAGGTG -> AGCCCTACTAACGGCCTCAGGTGC
TGTTGCTGCAGCCGGACGGCGTCC -> GTTGCTGCAGCCGGACGGCGTCCT
TAACTGCTTACCTGCATAATTACC -> AACTGCTTACCTGCATAATTACCG
CTGCATAATTACCGTCTTTGCTCA -> TGCATAATTACCGTCTTTGCTCAC
CCTCTCAAGATACTTATGTCTTAC -> CTCTCAAGATACTTATGTCTTACA
TGAAACCCGGGCAGGCGTCATACC -> GAAACCCGGGCAGGCGTCATACCG
GCCCCACGGATCTGGGATGCTTTC -> CCCCACGGATCTGGGATGCTTTCT
GTCGAGCCTCTGTTGAGGGGTATG -> TCGAGCCTCTGTTGAGGGGTATGG
GGTGAATAACACATCAAGGCACAC -> GTGAATAACACATCAAGGCACACG
CGACCGGCGGTCCGAGCTAATGTC -> GACCGGCGGTCCGAGCTAATGTCG
AACTCGGGCGTTCCGGCCGCCCGC -> ACTCGGGCGTTCCGGCCGCCCGCG
ACATCCATGTTGAAAAAAATGAGC -> CATCCATGTTGAAAAAAATGAGCG
ATAACACATCAAGGCACACGCTTC -> TAACACATCAAGGCACACGCTTCG
GTATCCAGACATGTGCACTCGGAC -> TATCCAGACATGTGCACTCGGACC
TGGCCGCCCCACGGATCTGGGATG -> GGCCGCCCCACGGATCTGGGATGC
GCGGTCCGAGCTAATGTCGCTTCA -> CGGTCCGAGCTAATGTCGCTTCAT
AAACCTGACTTGAGTGTAGGCCTG -> AACCTGACTTGAGTGTAGGCCTGT
TGGTAAGTTGTCCCCGACGGACAT -> GGTAAGTTGTCCCCGACGGACATA
CTAATCCTGCCTTCAGCCCCTGCG -> TAATCCTGCCTTCAGCCCCTGCGG
CTCAGGTGCCCTCATCGGCAGATT -> TCAGGTGCCCTCATCGGCAGATTG
CGGGGGTACTCATAAGTTGGCACG -> GGGGGTACTCATAAGTTGGCACGC
ATTGGTGAATAACACATCAAGGCA -> TTGGTGAATAACACATCAAGGCAC
AACTGCAGTAACTGGAGGAAGCGC -> ACTGCAGTAACTGGAGGAAGCGCG
TGTCTTACGACCGGCGGTCCGAGC -> GTCTTACGACCGGCGGTCCGAGCT
ATATGCTGAAATGAAAAGCTGGTC -> TATGCTGAAATGAAAAGCTGGTCT
GCCTGTCACTTTGATCAGAGTAAG -> CCTGTCACTTTGATCAGAGTAAGA
AACAAATCTTTTTAAGCCAGAACA -> ACAAATCTTTTTAAGCCAGAACAT
GCTTTTCTACGGCTCACACAGAGC -> CTTTTCTACGGCTCACACAGAGCG
AGCAACTACCCCATTATTGGGATG -> GCAACTACCCCATTATTGGGATGG
CGTGTTCTCGGAGTAGCTAGTACC -> GTGTTCTCGGAGTAGCTAGTACCT
TCTAACACCCGTGTTCTCTTCCAG -> CTAACACCCGTGTTCTCTTCCAGG
CAGACCGCCAACCAAACGATGAGC -> AGACCGCCAACCAAACGATGAGCT
GTCGGGTATGACCCAAGAAGACAT -> TCGGGTATGACCCAAGAAGACATA
TGCGGCAGATGGGAGTGTTAGCAA -> GCGGCAGATGGGAGTGTTAGCAAG
CTACAGTAGTTTCTTTTGCGGAGT -> TACAGTAGTTTCTTTTGCGGAGTG
CTCGCCGTTTTAAGACGTAACCCA -> TCGCCGTTTTAAGACGTAACCCAG
TAAGTTGGCACGCTTCTAACACCC -> AAGTTGGCACGCTTCTAACACCCG
ACCTGACTTGAGTGTAGGCCTGTC -> CCTGACTTGAGTGTAGGCCTGTCA
AGACATGTGCACTCGGACCGAGCG -> GACATGTGCACTCGGACCGAGCGA
TACATTCTTTGCACATGTGAAGCC -> ACATTCTTTGCACATGTGAAGCCT
AATCTGCCGTAACAAATCTTTTTA -> ATCTGCCGTAACAAATCTTTTTAA
AAGAAGTGCAGGCGAGTAAAGATG -> AGAAGTGCAGGCGAGTAAAGATGG
CCCGGCCCTCCTTGGCAAACTCGG -> CCGGCCCTCCTTGGCAAACTCGGG
CTGTGCGAAGATTCCTTAATTCAG -> TGTGCGAAGATTCCTTAATTCAGA
CCGCCAACCAAACGATGAGCTGCA -> CGCCAACCAAACGATGAGCTGCAG
TTCTAACACCCGTGTTCTCTTCCA -> TCTAACACCCGTGTTCTCTTCCAG
CAGCTATGATCATGGCAGTGGGTA -> AGCTATGATCATGGCAGTGGGTAG
ATCGGCTATTTGGTAAGTTGTCCC -> TCGGCTATTTGGTAAGTTGTCCCC
CTTCATGGTCTGGATTGGTGAATA -> TTCATGGTCTGGATTGGTGAATAA
GAAACCCGGGCAGGCGTCATACCG -> AAACCCGGGCAGGCGTCATACCGG
ACCCCATTATTGGGATGGCCGCCC -> CCCCATTATTGGGATGGCCGCCCC
TGCTGAAATGAAAAGCTGGTCTGT -> GCTGAAATGAAAAGCTGGTCTGTC
GCCAGACGGACGTCTCATGCAATC -> CCAGACGGACGTCTCATGCAATCT
CTCTCAAGATACTTATGTCTTACA -> TCTCAAGATACTTATGTCTTACAT
AAACTTGCCCGGCCCTCCTTGGCA -> AACTTGCCCGGCCCTCCTTGGCAA
CCCTGTTAGGCCCCTTTTCATTTA -> CCTGTTAGGCCCCTTTTCATTTAG
AATGTCGCTTCATGGTCTGGATTG -> ATGTCGCTTCATGGTCTGGATTGG
TGGCACGCTTCTAACACCCGTGTT -> GGCACGCTTCTAACACCCGTGTTC
CGTGGCCACCGACCAGTCAAGACT -> GTGGCCACCGACCAGTCAAGACTC
GGGCACCAACTGTGGGTTTAAAGT -> GGCACCAACTGTGGGTTTAAAGTC
TTCTCGGAGTAGCTAGTACCTGGT -> TCTCGGAGTAGCTAGTACCTGGTA
CACATCGTGGAGTGGACTCTTAAA -> ACATCGTGGAGTGGACTCTTAAAA
ACTAGCTTCTCTCTTCATCAGTCC -> CTAGCTTCTCTCTTCATCAGTCCG
CTGCGGCTTATAGTGGCAAGGCTA -> TGCGGCTTATAGTGGCAAGGCTAC
TTGAGGGGTATGGGCTTTTCTACG -> TGAGGGGTATGGGCTTTTCTACGG
CCTACTAACGGCCTCAGGTGCCCT -> CTACTAACGGCCTCAGGTGCCCTC
TCGGAGTGTCTGTTGCTGCAGCCG -> CGGAGTGTCTGTTGCTGCAGCCGG
TTGCTGTGTTGTTTGGTCGTGGCC -> TGCTGTGTTGTTTGGTCGTGGCCA
GAGCCTCTGTTGAGGGGTATGGGC -> AGCCTCTGTTGAGGGGTATGGGCT
CGAGCGACCTCCACCTGTAAGAAA -> GAGCGACCTCCACCTGTAAGAAAA
CTCGGAGTGTCTGTTGCTGCAGCC -> TCGGAGTGTCTGTTGCTGCAGCCG
GTAGCTAGTACCTGGTACTGCGCC -> TAGCTAGTACCTGGTACTGCGCCG
ACTGCGCCGTCGGACTGAGGCCTC -> CTGCGCCGTCGGACTGAGGCCTCC
CGATCCTGCCGAAACATCCATGTT -> GATCCTGCCGAAACATCCATGTTG
CTGAGGCCTCCATTCCCTAAGGTA -> TGAGGCCTCCATTCCCTAAGGTAC
GCTTTTCTTTTTGTCATGAACGCG -> CTTTTCTTTTTGTCATGAACGCGG
ATGCATTCAGTATACATCTTACTC -> TGCATTCAGTATACATCTTACTCC
ATGTGAAGCCTAGCATACGTTTCA -> TGTGAAGCCTAGCATACGTTTCAT
TGGGCTTTTCTACGGCTCACACAG -> GGGCTTTTCTACGGCTCACACAGA
TGACCACGTCATTGCGGCCGCAGT -> GACCACGTCATTGCGGCCGCAGTT
CAGAGCGAAGTTCCAATTCCAACT -> AGAGCGAAGTTCCAATTCCAACTG
GCCGTAACAAATCTTTTTAAGCCA -> CCGTAACAAATCTTTTTAAGCCAG
CACAGACTATTGAGCAACTACCCC -> ACAGACTATTGAGCAACTACCCCA
CGATCCCCTGTTAGGCCCCTTTTC -> GATCCCCTGTTAGGCCCCTTTTCA
TGGGTAGTCTAGGCAGCTCGGAGT -> GGGTAGTCTAGGCAGCTCGGAGTG
TATGATCATGGCAGTGGGTAGTCT -> ATGATCATGGCAGTGGGTAGTCTA
CCCGACGGACATACACAATGTGTT -> CCGACGGACATACACAATGTGTTT
TACATTGCTGTGTTGTTTGGTCGT -> ACATTGCTGTGTTGTTTGGTCGTG
GCATTGGGTAACTGTTCTACGCTG -> CATTGGGTAACTGTTCTACGCTGG
TGTCACCTTACCAAGCAGTTAGTT -> GTCACCTTACCAAGCAGTTAGTTA
ACATGTGAAGCCTAGCATACGTTT -> CATGTGAAGCCTAGCATACGTTTC
GGACGGCGTCCTCCATAGGAATGC -> GACGGCGTCCTCCATAGGAATGCG
GTTGTAGGACTGTATATCCCCCCT -> TTGTAGGACTGTATATCCCCCCTC
CGGGACCGGGACTTTGACCGCACT -> GGGACCGGGACTTTGACCGCACTC
CCGTTACCAAACTTGCCCGGCCCT -> CGTTACCAAACTTGCCCGGCCCTC
TGTTCTACGCTGGGATCAACACGG -> GTTCTACGCTGGGATCAACACGGA
GTGGCCACCGACCAGTCAAGACTC -> TGGCCACCGACCAGTCAAGACTCT
CCTGCATAATTACCGTCTTTGCTC -> CTGCATAATTACCGTCTTTGCTCA
GGCCTCCATTCCCTAAGGTACATT -> GCCTCCATTCCCTAAGGTACATTG
CCTCCATTCCCTAAGGTACATTGC -> CTCCATTCCCTAAGGTACATTGCT
CCCAAGCAGTGCCAGACTTGACGT -> CCAAGCAGTGCCAGACTTGACGTC
ATGCGACGGAGCCCAGTTATCCTT -> TGCGACGGAGCCCAGTTATCCTTT
AGTATACATCTTACTCCTGTGTGT -> GTATACATCTTACTCCTGTGTGTT
ACATTCTTTGCACATGTGAAGCCT -> CATTCTTTGCACATGTGAAGCCTA
TTATGTCTTACATGGATCAAGTAT -> TATGTCTTACATGGATCAAGTATC
GCGGAGTGGATTCCCTACCGGGAC -> CGGAGTGGATTCCCTACCGGGACC
GACTCTTAAAACCTGACTTGAGTG -> ACTCTTAAAACCTGACTTGAGTGT
CCGCTTGCTGACGAACGAATGAAG -> CGCTTGCTGACGAACGAATGAAGT
ACAGACTATTGAGCAACTACCCCA -> CAGACTATTGAGCAACTACCCCAT
GTCTCATGCAATCTGCCGTAACAA -> TCTCATGCAATCTGCCGTAACAAA
GGAATGCGACGGAGCCCAGTTATC -> GAATGCGACGGAGCCCAGTTATCC
CCGTAACAAATCTTTTTAAGCCAG -> CGTAACAAATCTTTTTAAGCCAGA
TTGTAGGACTGTATATCCCCCCTC -> TGTAGGACTGTATATCCCCCCTCA
TGATAGTACGGAAAGAAGTTGTCG -> GATAGTACGGAAAGAAGTTGTCGA
TGTGCACTCGGACCGAGCGACCTC -> GTGCACTCGGACCGAGCGACCTCC
CGGACGTCTCATGCAATCTGCCGT -> GGACGTCTCATGCAATCTGCCGTA
TGTTGTCCTGATAGTACGGAAAGA -> GTTGTCCTGATAGTACGGAAAGAA
GACCAGCATTGGGTAACTGTTCTA -> ACCAGCATTGGGTAACTGTTCTAC
TGGTCTGGATTGGTGAATAACACA -> GGTCTGGATTGGTGAATAACACAT
AATCTTTTTAAGCCAGAACATGAA -> ATCTTTTTAAGCCAGAACATGAAC
CCTGTGCGAAGATTCCTTAATTCA -> CTGTGCGAAGATTCCTTAATTCAG
CCTGTTGTAGGACTGTATATCCCC -> CTGTTGTAGGACTGTATATCCCCC
TGGACTCTTAAAACCTGACTTGAG -> GGACTCTTAAAACCTGACTTGAGT
ATCTGAGTTAGCAACGTAGCCTCT -> TCTGAGTTAGCAACGTAGCCTCTC
TTCCGGCCGCCCGCGAAGCCCTAC -> TCCGGCCGCCCGCGAAGCCCTACT
TTGCTGCAGCCGGACGGCGTCCTC -> TGCTGCAGCCGGACGGCGTCCTCC
CATCAAGGCACACGCTTCGGGGAC -> ATCAAGGCACACGCTTCGGGGACT
TGCAGCGACCAGCATTGGGTAACT -> GCAGCGACCAGCATTGGGTAACTG
ATACGTTTCATCTACAGAAAAAAA -> TACGTTTCATCTACAGAAAAAAAT
GCGGCGGTATACGTTTATGCAGCG -> CGGCGGTATACGTTTATGCAGCGA
TAGCTAGTACCTGGTACTGCGCCG -> AGCTAGTACCTGGTACTGCGCCGT
ACGCGGCAAGGGGTTAGATAATGT -> CGCGGCAAGGGGTTAGATAATGTC
GGCCACCGGGCATGTTAAGTCTGT -> GCCACCGGGCATGTTAAGTCTGTC
AAATCTGTGCATAACACTCTCCCG -> AATCTGTGCATAACACTCTCCCGG
GCAAGGGGTTAGATAATGTCCATG -> CAAGGGGTTAGATAATGTCCATGG
GGGGGTACTCATAAGTTGGCACGC -> GGGGTACTCATAAGTTGGCACGCT
TTGCTCACGAATCTTCACCTCATT -> TGCTCACGAATCTTCACCTCATTC
CCGACCGAAGCGATTCCTATTACC -> CGACCGAAGCGATTCCTATTACCT
AGACACACCGATCCCCTGTTAGGC -> GACACACCGATCCCCTGTTAGGCC
TTAAGCCAGAACATGAACAAAGCA -> TAAGCCAGAACATGAACAAAGCAG
CAACTGTGGGTTTAAAGTCGCCGC -> AACTGTGGGTTTAAAGTCGCCGCT
ACTGAAACCCGGGCAGGCGTCATA -> CTGAAACCCGGGCAGGCGTCATAC
GCTAATGTCGCTTCATGGTCTGGA -> CTAATGTCGCTTCATGGTCTGGAT
AACACCATTTAGGACTTTGCTACT -> ACACCATTTAGGACTTTGCTACTA
AAACTATGCCAGACGGACGTCTCA -> AACTATGCCAGACGGACGTCTCAT
GTTAGTTAGGAGGCTAGGGGCATA -> TTAGTTAGGAGGCTAGGGGCATAC
CACAACGGCATAGTCAATTGTATC -> ACAACGGCATAGTCAATTGTATCC
CGTTACCAAACTTGCCCGGCCCTC -> GTTACCAAACTTGCCCGGCCCTCC
TGAGCTGCAGGGATGCACTTCAGT -> GAGCTGCAGGGATGCACTTCAGTG
TCGCCGCTTAGAATGCATTCAGTA -> CGCCGCTTAGAATGCATTCAGTAT
CCAAGCAGTTAGTTAGGAGGCTAG -> CAAGCAGTTAGTTAGGAGGCTAGG
ATACGCGATCCTGCCGAAACATCC -> TACGCGATCCTGCCGAAACATCCA
AGGCGTCATACCGGGGATACACCT -> GGCGTCATACCGGGGATACACCTG
GCAGCGACCAGCATTGGGTAACTG -> CAGCGACCAGCATTGGGTAACTGT
GGCCTCAGGTGCCCTCATCGGCAG -> GCCTCAGGTGCCCTCATCGGCAGA
TACCCCATTATTGGGATGGCCGCC -> ACCCCATTATTGGGATGGCCGCCC
CCAGACATGTGCACTCGGACCGAG -> CAGACATGTGCACTCGGACCGAGC
GGACTGAGGCCTCCATTCCCTAAG -> GACTGAGGCCTCCATTCCCTAAGG
TACCTCTGTCAGACACACCGATCC -> ACCTCTGTCAGACACACCGATCCC
GGCGTCATACCGGGGATACACCTG -> GCGTCATACCGGGGATACACCTGA
ACATACATTCTTTGCACATGTGAA -> CATACATTCTTTGCACATGTGAAG
CATAGTCAATTGTATCCCGCAAAA -> ATAGTCAATTGTATCCCGCAAAAA
AGACTACGGGAACTAATCCTGCCT -> GACTACGGGAACTAATCCTGCCTT
GCAGGAATATGCTGAAATGAAAAG -> CAGGAATATGCTGAAATGAAAAGC
TAGCAACGTAGCCTCTCAAGATAC -> AGCAACGTAGCCTCTCAAGATACT
AGAAGTTGTCGAGCCTCTGTTGAG -> GAAGTTGTCGAGCCTCTGTTGAGG
TAGTGGCAAGGCTACAGTAGTTTC -> AGTGGCAAGGCTACAGTAGTTTCT
ATTGGGATGGCCGCCCCACGGATC -> TTGGGATGGCCGCCCCACGGATCT
CCACCGGGCATGTTAAGTCTGTCA -> CACCGGGCATGTTAAGTCTGTCAC
CCGGCCCTCCTTGGCAAACTCGGG -> CGGCCCTCCTTGGCAAACTCGGGC
ATGTCTTACATGGATCAAGTATCT -> TGTCTTACATGGATCAAGTATCTC
CGCCCGACCGAAGCGATTCCTATT -> GCCCGACCGAAGCGATTCCTATTA
GGCCCCCCGGCTACAGTGGGATTC -> GCCCCCCGGCTACAGTGGGATTCA
AAGCTGGTCTGTCTTACGACCGGC -> AGCTGGTCTGTCTTACGACCGGCG
AAAAATCTGTGCATAACACTCTCC -> AAAATCTGTGCATAACACTCTCCC
ATCCTGAGCGGGGGTACTCATAAG -> TCCTGAGCGGGGGTACTCATAAGT
ATCAGAGTAAGATGGGCACCAACT -> TCAGAGTAAGATGGGCACCAACTG
GCCTTCAGCCCCTGCGGCTTATAG -> CCTTCAGCCCCTGCGGCTTATAGT
CCTCAATCAGCATTCCGACTACAC -> CTCAATCAGCATTCCGACTACACA
GACGAAACACCATTTAGGACTTTG -> ACGAAACACCATTTAGGACTTTGC
GGACTTTGACCGCACTCCTATCAC -> GACTTTGACCGCACTCCTATCACA
CCACAGACTATTGAGCAACTACCC -> CACAGACTATTGAGCAACTACCCC
TGTAAATCCACTCAGTATGTATTG -> GTAAATCCACTCAGTATGTATTGG
CAAACTTGCCCGGCCCTCCTTGGC -> AAACTTGCCCGGCCCTCCTTGGCA
GGTATGCTTTCCTGTGCGAAGATT -> GTATGCTTTCCTGTGCGAAGATTC
TATGCTGAAATGAAAAGCTGGTCT -> ATGCTGAAATGAAAAGCTGGTCTG
TGCACTTCAGTGGGCCCTGTTGTA -> GCACTTCAGTGGGCCCTGTTGTAG
TGCCGTAACAAATCTTTTTAAGCC -> GCCGTAACAAATCTTTTTAAGCCA
TAACTGGAGGAAGCGCGCCCTCAA -> AACTGGAGGAAGCGCGCCCTCAAT
TTGACCGCACTCCTATCACAACGG -> TGACCGCACTCCTATCACAACGGC
AGATAATGTCCATGGTCTCACATC -> GATAATGTCCATGGTCTCACATCT
ACTTATGTCTTACATGGATCAAGT -> CTTATGTCTTACATGGATCAAGTA
GTAACTGCTTACCTGCATAATTAC -> TAACTGCTTACCTGCATAATTACC
TAAGCCAGAACATGAACAAAGCAG -> AAGCCAGAACATGAACAAAGCAGG
ATCAAGGCACACGCTTCGGGGACT -> TCAAGGCACACGCTTCGGGGACTG
TTGGCACGCTTCTAACACCCGTGT -> TGGCACGCTTCTAACACCCGTGTT
TCTCTGTGACCACGTCATTGCGGC -> CTCTGTGACCACGTCATTGCGGCC
ACACATCAAGGCACACGCTTCGGG -> CACATCAAGGCACACGCTTCGGGG
TAACTGTTCTACGCTGGGATCAAC -> AACTGTTCTACGCTGGGATCAACA
GCCCCAAGCAGTGCCAGACTTGAC -> CCCCAAGCAGTGCCAGACTTGACG
AAACACCATTTAGGACTTTGCTAC -> AACACCATTTAGGACTTTGCTACT
TACCTGCATAATTACCGTCTTTGC -> ACCTGCATAATTACCGTCTTTGCT
TCATCTACAGAAAAAAATCTGTGC -> CATCTACAGAAAAAAATCTGTGCA
AGACGGACGTCTCATGCAATCTGC -> GACGGACGTCTCATGCAATCTGCC
CCTGAGCGGGGGTACTCATAAGTT -> CTGAGCGGGGGTACTCATAAGTTG
ATTCCCTACCGGGACCGGGACTTT -> TTCCCTACCGGGACCGGGACTTTG
CAGCGACCAGCATTGGGTAACTGT -> AGCGACCAGCATTGGGTAACTGTT
AACACCCGTGTTCTCTTCCAGGAA -> ACACCCGTGTTCTCTTCCAGGAAA
AGCTAGTACCTGGTACTGCGCCGT -> GCTAGTACCTGGTACTGCGCCGTC
TGTTACTCACATCGTGGAGTGGAC -> GTTACTCACATCGTGGAGTGGACT
TACCAAGCAGTTAGTTAGGAGGCT -> ACCAAGCAGTTAGTTAGGAGGCTA
TCATTTAGCTTTTCTTTTTGTCAT -> CATTTAGCTTTTCTTTTTGTCATG
AAGTTGTCCCCGACGGACATACAC -> AGTTGTCCCCGACGGACATACACA
GCCCGACCGAAGCGATTCCTATTA -> CCCGACCGAAGCGATTCCTATTAC
TTGGGTATGCTTTCCTGTGCGAAG -> TGGGTATGCTTTCCTGTGCGAAGA
GCAAGTCATAGAGCCACATACTGA -> CAAGTCATAGAGCCACATACTGAA
TGACGAACGAATGAAGTGGCAAAT -> GACGAACGAATGAAGTGGCAAATC
CTCTCTTCATCAGTCCGTACGCCC -> TCTCTTCATCAGTCCGTACGCCCG
CATTCAGTATACATCTTACTCCTG -> ATTCAGTATACATCTTACTCCTGT
CATCGGCTATTTGGTAAGTTGTCC -> ATCGGCTATTTGGTAAGTTGTCCC
AAGGTACATTGCTGTGTTGTTTGG -> AGGTACATTGCTGTGTTGTTTGGT
GCAGATGGGAGTGTTAGCAAGCGC -> CAGATGGGAGTGTTAGCAAGCGCC
CTTAAAACCTGACTTGAGTGTAGG -> TTAAAACCTGACTTGAGTGTAGGC
GGCAAGGGGTTAGATAATGTCCAT -> GCAAGGGGTTAGATAATGTCCATG
AGTTCAGAGGCGGCGGTATACGTT -> GTTCAGAGGCGGCGGTATACGTTT
TATCCAGACATGTGCACTCGGACC -> ATCCAGACATGTGCACTCGGACCG
TAGCAAGCGCCCATGGGTCACGTC -> AGCAAGCGCCCATGGGTCACGTCG
ATCCACTCAGTATGTATTGGCCCC -> TCCACTCAGTATGTATTGGCCCCA
CAGACCGCCCAGTAGCACTCAATG -> AGACCGCCCAGTAGCACTCAATGT
AAGCGATTCCTATTACCTCTGTCA -> AGCGATTCCTATTACCTCTGTCAG
AGCCAGAACATGAACAAAGCAGGA -> GCCAGAACATGAACAAAGCAGGAA
CCTTAATTCAGACCGCCAACCAAA -> CTTAATTCAGACCGCCAACCAAAC
GCTTCTAACACCCGTGTTCTCTTC -> CTTCTAACACCCGTGTTCTCTTCC
TATGCAGCGACCAGCATTGGGTAA -> ATGCAGCGACCAGCATTGGGTAAC
GTATGGGCTTTTCTACGGCTCACA -> TATGGGCTTTTCTACGGCTCACAC
AGTAACTGGAGGAAGCGCGCCCTC -> GTAACTGGAGGAAGCGCGCCCTCA
GGCCGCAGTTGGGTATGCTTTCCT -> GCCGCAGTTGGGTATGCTTTCCTG
AGGGGCATACCACAGACTATTGAG -> GGGGCATACCACAGACTATTGAGC
AAAAGCTGGTCTGTCTTACGACCG -> AAAGCTGGTCTGTCTTACGACCGG
GGCCCTGTTGTAGGACTGTATATC -> GCCCTGTTGTAGGACTGTATATCC
TTGAGTGTAGGCCTGTCACTTTGA -> TGAGTGTAGGCCTGTCACTTTGAT
AGTACGGAAAGAAGTTGTCGAGCC -> GTACGGAAAGAAGTTGTCGAGCCT
GGAGCCCAGTTATCCTTTCCTACA -> GAGCCCAGTTATCCTTTCCTACAA
TCCCCGACGGACATACACAATGTG -> CCCCGACGGACATACACAATGTGT
GTATCCCGCAAAAATACCCTGACG -> TATCCCGCAAAAATACCCTGACGA
ACCGCCAACCAAACGATGAGCTGC -> CCGCCAACCAAACGATGAGCTGCA
GACCGAGCGACCTCCACCTGTAAG -> ACCGAGCGACCTCCACCTGTAAGA
CGGCAGATGGGAGTGTTAGCAAGC -> GGCAGATGGGAGTGTTAGCAAGCG
CGATTCCTATTACCTCTGTCAGAC -> GATTCCTATTACCTCTGTCAGACA
TAGCATACGTTTCATCTACAGAAA -> AGCATACGTTTCATCTACAGAAAA
TAGCTTTTCTTTTTGTCATGAACG -> AGCTTTTCTTTTTGTCATGAACGC
GGATCAAGTATCTCTGTGACCACG -> GATCAAGTATCTCTGTGACCACGT
GACGTCTTAGACTACGGGAACTAA -> ACGTCTTAGACTACGGGAACTAAT
ACGCTTCTAACACCCGTGTTCTCT -> CGCTTCTAACACCCGTGTTCTCTT
CCCAGACCGCCCAGTAGCACTCAA -> CCAGACCGCCCAGTAGCACTCAAT
TGGATCAAGTATCTCTGTGACCAC -> GGATCAAGTATCTCTGTGACCACG
CAGACACACCGATCCCCTGTTAGG -> AGACACACCGATCCCCTGTTAGGC
CAAGTATCTCTGTGACCACGTCAT -> AAGTATCTCTGTGACCACGTCATT
ATACGTTTATGCAGCGACCAGCAT -> TACGTTTATGCAGCGACCAGCATT
TACCAAACTTGCCCGGCCCTCCTT -> ACCAAACTTGCCCGGCCCTCCTTG
ATCGTGGAGTGGACTCTTAAAACC -> TCGTGGAGTGGACTCTTAAAACCT
AGTGTCTGTTGCTGCAGCCGGACG -> GTGTCTGTTGCTGCAGCCGGACGG
CCTTTCCTACAATCCTGAGCGGGG -> CTTTCCTACAATCCTGAGCGGGGG
TTACCTCTGTCAGACACACCGATC -> TACCTCTGTCAGACACACCGATCC
CGCAGTTGGGTATGCTTTCCTGTG -> GCAGTTGGGTATGCTTTCCTGTGC
CTCTGTTGAGGGGTATGGGCTTTT -> TCTGTTGAGGGGTATGGGCTTTTC
CATTAGGCCCCCCGGCTACAGTGG -> ATTAGGCCCCCCGGCTACAGTGGG
CCGGGGATACACCTGAGATGCGCC -> CGGGGATACACCTGAGATGCGCCC
AGTGTAGGCCTGTCACTTTGATCA -> GTGTAGGCCTGTCACTTTGATCAG
TCCTTAATTCAGACCGCCAACCAA -> CCTTAATTCAGACCGCCAACCAAA
TCGGGTATGACCCAAGAAGACATA -> CGGGTATGACCCAAGAAGACATAC
TTCCGTGTTCTCGGAGTAGCTAGT -> TCCGTGTTCTCGGAGTAGCTAGTA
TGTGCGAAGATTCCTTAATTCAGA -> GTGCGAAGATTCCTTAATTCAGAC
CGCCCCACGGATCTGGGATGCTTT -> GCCCCACGGATCTGGGATGCTTTC
AACGCCTAATCATCGGCTATTTGG -> ACGCCTAATCATCGGCTATTTGGT
AGTGGATTCCCTACCGGGACCGGG -> GTGGATTCCCTACCGGGACCGGGA
CCATTTAGGACTTTGCTACTAGCT -> CATTTAGGACTTTGCTACTAGCTT
TCTACGCTGGGATCAACACGGATA -> CTACGCTGGGATCAACACGGATAT
CCCCTGCGGCTTATAGTGGCAAGG -> CCCTGCGGCTTATAGTGGCAAGGC
GCCGCTTAGAATGCATTCAGTATA -> CCGCTTAGAATGCATTCAGTATAC
AGGAAACTATGCCAGACGGACGTC -> GGAAACTATGCCAGACGGACGTCT
CTCCTATCACAACGGCATAGTCAA -> TCCTATCACAACGGCATAGTCAAT
AGTCAAGACTCTAATAGTGTAAGA -> GTCAAGACTCTAATAGTGTAAGAA
AGCTGCAGGGATGCACTTCAGTGG -> GCTGCAGGGATGCACTTCAGTGGG
CATAGGAATGCGACGGAGCCCAGT -> ATAGGAATGCGACGGAGCCCAGTT
TGAGCGGGGGTACTCATAAGTTGG -> GAGCGGGGGTACTCATAAGTTGGC
TGCGACGGAGCCCAGTTATCCTTT -> GCGACGGAGCCCAGTTATCCTTTC
GCTTCTCTCTTCATCAGTCCGTAC -> CTTCTCTCTTCATCAGTCCGTACG
GCGTCCTCCATAGGAATGCGACGG -> CGTCCTCCATAGGAATGCGACGGA
CATACCACAGACTATTGAGCAACT -> ATACCACAGACTATTGAGCAACTA
GATACACCTGAGATGCGCCCGAAC -> ATACACCTGAGATGCGCCCGAACG
TACGCTGGGATCAACACGGATATA -> ACGCTGGGATCAACACGGATATAC
TGGCAAATCACTTGCATCACGGTA -> GGCAAATCACTTGCATCACGGTAA
TTTCATTTAGCTTTTCTTTTTGTC -> TTCATTTAGCTTTTCTTTTTGTCA
CCTGGTACTGCGCCGTCGGACTGA -> CTGGTACTGCGCCGTCGGACTGAG
AACACGGATATACGCGATCCTGCC -> ACACGGATATACGCGATCCTGCCG
GAAGTTGTCGAGCCTCTGTTGAGG -> AAGTTGTCGAGCCTCTGTTGAGGG
ACCTGGTACTGCGCCGTCGGACTG -> CCTGGTACTGCGCCGTCGGACTGA
ACGGCATAGTCAATTGTATCCCGC -> CGGCATAGTCAATTGTATCCCGCA
GTCCGATAAGGTGCGGCAGATGGG -> TCCGATAAGGTGCGGCAGATGGGA
CATGCAATCTGCCGTAACAAATCT -> ATGCAATCTGCCGTAACAAATCTT
GTGTTGTCCTGATAGTACGGAAAG -> TGTTGTCCTGATAGTACGGAAAGA
TCCGTGTTGTCCTGATAGTACGGA -> CCGTGTTGTCCTGATAGTACGGAA
CCCTGACGAAACACCATTTAGGAC -> CCTGACGAAACACCATTTAGGACT
CTTTGACCGCACTCCTATCACAAC -> TTTGACCGCACTCCTATCACAACG
GCCGAAACATCCATGTTGAAAAAA -> CCGAAACATCCATGTTGAAAAAAA
GTTGCTGCAGCCGGACGGCGTCCT -> TTGCTGCAGCCGGACGGCGTCCTC
TGGGAGTGTTAGCAAGCGCCCATG -> GGGAGTGTTAGCAAGCGCCCATGG
CGGCAGATTGCAAGTCATAGAGCC -> GGCAGATTGCAAGTCATAGAGCCA
CCCTTTTCATTTAGCTTTTCTTTT -> CCTTTTCATTTAGCTTTTCTTTTT
GACCAGTCAAGACTCTAATAGTGT -> ACCAGTCAAGACTCTAATAGTGTA
GATATACGCGATCCTGCCGAAACA -> ATATACGCGATCCTGCCGAAACAT
CGTCATTGCGGCCGCAGTTGGGTA -> GTCATTGCGGCCGCAGTTGGGTAT
GCAGTTAGTTAGGAGGCTAGGGGC -> CAGTTAGTTAGGAGGCTAGGGGCA
TATCCCGCAAAAATACCCTGACGA -> ATCCCGCAAAAATACCCTGACGAA
CCCACGGATCTGGGATGCTTTCTC -> CCACGGATCTGGGATGCTTTCTCG
ACTCACATCGTGGAGTGGACTCTT -> CTCACATCGTGGAGTGGACTCTTA
ATTCAGACCGCCAACCAAACGATG -> TTCAGACCGCCAACCAAACGATGA
CGCCCAGTAGCACTCAATGTCGGG -> GCCCAGTAGCACTCAATGTCGGGT
TTCAGTATACATCTTACTCCTGTG -> TCAGTATACATCTTACTCCTGTGT
TCTACGGCTCACACAGAGCGAAGT -> CTACGGCTCACACAGAGCGAAGTT
TACAGAAAAAAATCTGTGCATAAC -> ACAGAAAAAAATCTGTGCATAACA
GAACGAATGAAGTGGCAAATCACT -> AACGAATGAAGTGGCAAATCACTT
CCACATACTGAAACCCGGGCAGGC -> CACATACTGAAACCCGGGCAGGCG
AGGTACATTGCTGTGTTGTTTGGT -> GGTACATTGCTGTGTTGTTTGGTC
CTGGTCTGTCTTACGACCGGCGGT -> TGGTCTGTCTTACGACCGGCGGTC
GGCAGTGGGTAGTCTAGGCAGCTC -> GCAGTGGGTAGTCTAGGCAGCTCG
CATCTACAGAAAAAAATCTGTGCA -> ATCTACAGAAAAAAATCTGTGCAT
CCGTGTTCTCTTCCAGGAAACTAT -> CGTGTTCTCTTCCAGGAAACTATG
CAGTGGGATTCACGTTGTAAATCC -> AGTGGGATTCACGTTGTAAATCCA
ATCCCCCCTCATGAGTCACCATTC -> TCCCCCCTCATGAGTCACCATTCT
CGCGAAGCCCTACTAACGGCCTCA -> GCGAAGCCCTACTAACGGCCTCAG
CGGGCGTTCCGGCCGCCCGCGAAG -> GGGCGTTCCGGCCGCCCGCGAAGC
CACTCGGACCGAGCGACCTCCACC -> ACTCGGACCGAGCGACCTCCACCT
CTTTCCTACAATCCTGAGCGGGGG -> TTTCCTACAATCCTGAGCGGGGGT
CACGGATCTGGGATGCTTTCTCGC -> ACGGATCTGGGATGCTTTCTCGCC
CAGTAGTTTCTTTTGCGGAGTGGA -> AGTAGTTTCTTTTGCGGAGTGGAT
GACGGACATACACAATGTGTTTTG -> ACGGACATACACAATGTGTTTTGG
AGTCCGTACGCCCGACCGAAGCGA -> GTCCGTACGCCCGACCGAAGCGAT
CCTTTTCATTTAGCTTTTCTTTTT -> CTTTTCATTTAGCTTTTCTTTTTG
ACTGGCTAAGGTCCGATAAGGTGC -> CTGGCTAAGGTCCGATAAGGTGCG
ATCTTCACCTCATTCCGTGTTGTC -> TCTTCACCTCATTCCGTGTTGTCC
AATCTTCACCTCATTCCGTGTTGT -> ATCTTCACCTCATTCCGTGTTGTC
TTGGTCGTGGCCACCGACCAGTCA -> TGGTCGTGGCCACCGACCAGTCAA
AAGTTCCAATTCCAACTGCAGTAA -> AGTTCCAATTCCAACTGCAGTAAC
GGGCAGGCGTCATACCGGGGATAC -> GGCAGGCGTCATACCGGGGATACA
CAGAGGCGGCGGTATACGTTTATG -> AGAGGCGGCGGTATACGTTTATGC
TGCATAACACTCTCCCGGACATTA -> GCATAACACTCTCCCGGACATTAG
GCAACGTAGCCTCTCAAGATACTT -> CAACGTAGCCTCTCAAGATACTTA
ACCCGGGCAGGCGTCATACCGGGG -> CCCGGGCAGGCGTCATACCGGGGA
CCGCCCCACGGATCTGGGATGCTT -> CGCCCCACGGATCTGGGATGCTTT
TATGCCAGACGGACGTCTCATGCA -> ATGCCAGACGGACGTCTCATGCAA
AGTGGACTCTTAAAACCTGACTTG -> GTGGACTCTTAAAACCTGACTTGA
GCTCACACAGAGCGAAGTTCCAAT -> CTCACACAGAGCGAAGTTCCAATT
AGCCTCTGTTGAGGGGTATGGGCT -> GCCTCTGTTGAGGGGTATGGGCTT
AAGCGCGCCCTCAATCAGCATTCC -> AGCGCGCCCTCAATCAGCATTCCG
ATGGTCTGGATTGGTGAATAACAC -> TGGTCTGGATTGGTGAATAACACA
CGTCTCATGCAATCTGCCGTAACA -> GTCTCATGCAATCTGCCGTAACAA
GGCCTGTCACTTTGATCAGAGTAA -> GCCTGTCACTTTGATCAGAGTAAG
ATGTCGCTTCATGGTCTGGATTGG -> TGTCGCTTCATGGTCTGGATTGGT
GACGGCGTCCTCCATAGGAATGCG -> ACGGCGTCCTCCATAGGAATGCGA
GCCGTCGGACTGAGGCCTCCATTC -> CCGTCGGACTGAGGCCTCCATTCC
CGGCGGTATACGTTTATGCAGCGA -> GGCGGTATACGTTTATGCAGCGAC
AAGTTGGCACGCTTCTAACACCCG -> AGTTGGCACGCTTCTAACACCCGT
ATTGCTGTGTTGTTTGGTCGTGGC -> TTGCTGTGTTGTTTGGTCGTGGCC
TCACGTCGGGCCACCGGGCATGTT -> CACGTCGGGCCACCGGGCATGTTA
GCCGCCCGCGAAGCCCTACTAACG -> CCGCCCGCGAAGCCCTACTAACGG
TTACTCCTGTGTGTTGCTATGGCC -> TACTCCTGTGTGTTGCTATGGCCC
GTGGGCCCTGTTGTAGGACTGTAT -> TGGGCCCTGTTGTAGGACTGTATA
AGTCAATTGTATCCCGCAAAAATA -> GTCAATTGTATCCCGCAAAAATAC
GGGCCCTGTTGTAGGACTGTATAT -> GGCCCTGTTGTAGGACTGTATATC
GGCATACCACAGACTATTGAGCAA -> GCATACCACAGACTATTGAGCAAC
CTACGGGAACTAATCCTGCCTTCA -> TACGGGAACTAATCCTGCCTTCAG
CTTGGCAAACTCGGGCGTTCCGGC -> TTGGCAAACTCGGGCGTTCCGGCC
CATACATTCTTTGCACATGTGAAG -> ATACATTCTTTGCACATGTGAAGC
TCATGGCAGTGGGTAGTCTAGGCA -> CATGGCAGTGGGTAGTCTAGGCAG
GTCTTTGCTCACGAATCTTCACCT -> TCTTTGCTCACGAATCTTCACCTC
GTAACAAATCTTTTTAAGCCAGAA -> TAACAAATCTTTTTAAGCCAGAAC
TCACCTCATTCCGTGTTGTCCTGA -> CACCTCATTCCGTGTTGTCCTGAT
TCACTTGCATCACGGTAACTGCTT -> CACTTGCATCACGGTAACTGCTTA
ACATCTGAGTTAGCAACGTAGCCT -> CATCTGAGTTAGCAACGTAGCCTC
GACCGCACTCCTATCACAACGGCA -> ACCGCACTCCTATCACAACGGCAT
TGGGATTCACGTTGTAAATCCACT -> GGGATTCACGTTGTAAATCCACTC
CGGCCTCAGGTGCCCTCATCGGCA -> GGCCTCAGGTGCCCTCATCGGCAG
AACGTAGCCTCTCAAGATACTTAT -> ACGTAGCCTCTCAAGATACTTATG
AGCTAATGTCGCTTCATGGTCTGG -> GCTAATGTCGCTTCATGGTCTGGA
GCCCGAACGCCTAATCATCGGCTA -> CCCGAACGCCTAATCATCGGCTAT
ACGGTAACTGCTTACCTGCATAAT -> CGGTAACTGCTTACCTGCATAATT
AGTAGCACTCAATGTCGGGTATGA -> GTAGCACTCAATGTCGGGTATGAC
CCCGGCTACAGTGGGATTCACGTT -> CCGGCTACAGTGGGATTCACGTTG
TTTTTGTCATGAACGCGGCAAGGG -> TTTTGTCATGAACGCGGCAAGGGG
AAGGTCCGATAAGGTGCGGCAGAT -> AGGTCCGATAAGGTGCGGCAGATG
TCCATGGTCTCACATCTGAGTTAG -> CCATGGTCTCACATCTGAGTTAGC
CAAACTCGGGCGTTCCGGCCGCCC -> AAACTCGGGCGTTCCGGCCGCCCG
ACGCGATCCTGCCGAAACATCCAT -> CGCGATCCTGCCGAAACATCCATG
CCCCGGCTACAGTGGGATTCACGT -> CCCGGCTACAGTGGGATTCACGTT
TGCGGAGTGGATTCCCTACCGGGA -> GCGGAGTGGATTCCCTACCGGGAC
GTCTGTCTTACGACCGGCGGTCCG -> TCTGTCTTACGACCGGCGGTCCGA
ACGGAGCCCAGTTATCCTTTCCTA -> CGGAGCCCAGTTATCCTTTCCTAC
AAAATGAGCGTGTTACTCACATCG -> AAATGAGCGTGTTACTCACATCGT
TCAGACACACCGATCCCCTGTTAG -> CAGACACACCGATCCCCTGTTAGG
CCGGACGGCGTCCTCCATAGGAAT -> CGGACGGCGTCCTCCATAGGAATG
TCCTATCACAACGGCATAGTCAAT -> CCTATCACAACGGCATAGTCAATT
AATACCCTGACGAAACACCATTTA -> ATACCCTGACGAAACACCATTTAG
GCGGCAAGGGGTTAGATAATGTCC -> CGGCAAGGGGTTAGATAATGTCCA
GCATAATTACCGTCTTTGCTCACG -> CATAATTACCGTCTTTGCTCACGA
AGGTCCGATAAGGTGCGGCAGATG -> GGTCCGATAAGGTGCGGCAGATGG
CCGAACGCCTAATCATCGGCTATT -> CGAACGCCTAATCATCGGCTATTT
TCGGGCCACCGGGCATGTTAAGTC -> CGGGCCACCGGGCATGTTAAGTCT
ATCAAGTATCTCTGTGACCACGTC -> TCAAGTATCTCTGTGACCACGTCA
GAAGACATACATTCTTTGCACATG -> AAGACATACATTCTTTGCACATGT
CAGCATTGGGTAACTGTTCTACGC -> AGCATTGGGTAACTGTTCTACGCT
CAACTGCAGTAACTGGAGGAAGCG -> AACTGCAGTAACTGGAGGAAGCGC
CGTCGGGCCACCGGGCATGTTAAG -> GTCGGGCCACCGGGCATGTTAAGT
GGGGTACTCATAAGTTGGCACGCT -> GGGTACTCATAAGTTGGCACGCTT
ACGCTGGGATCAACACGGATATAC -> CGCTGGGATCAACACGGATATACG
AGTCATAGAGCCACATACTGAAAC -> GTCATAGAGCCACATACTGAAACC
CCTTCAGCCCCTGCGGCTTATAGT -> CTTCAGCCCCTGCGGCTTATAGTG
GCGCCCGAACGCCTAATCATCGGC -> CGCCCGAACGCCTAATCATCGGCT
GTCTGTCACCTTACCAAGCAGTTA -> TCTGTCACCTTACCAAGCAGTTAG
ACGGACATACACAATGTGTTTTGG -> CGGACATACACAATGTGTTTTGGT
ATAAGGTGCGGCAGATGGGAGTGT -> TAAGGTGCGGCAGATGGGAGTGTT
AAGACGTAACCCAGACCGCCCAGT -> AGACGTAACCCAGACCGCCCAGTA
TGGGCCCTGTTGTAGGACTGTATA -> GGGCCCTGTTGTAGGACTGTATAT
TCCCGGACATTAGGCCCCCCGGCT -> CCCGGACATTAGGCCCCCCGGCTA
TCCAACTGCAGTAACTGGAGGAAG -> CCAACTGCAGTAACTGGAGGAAGC
TGCCAGACTTGACGTCTTAGACTA -> GCCAGACTTGACGTCTTAGACTAC
GATACTTATGTCTTACATGGATCA -> ATACTTATGTCTTACATGGATCAA
CTTTTCTACGGCTCACACAGAGCG -> TTTTCTACGGCTCACACAGAGCGA
CATTGCTGTGTTGTTTGGTCGTGG -> ATTGCTGTGTTGTTTGGTCGTGGC
CCGTTTTAAGACGTAACCCAGACC -> CGTTTTAAGACGTAACCCAGACCG
TTACGACCGGCGGTCCGAGCTAAT -> TACGACCGGCGGTCCGAGCTAATG
AGTGGCAAGGCTACAGTAGTTTCT -> GTGGCAAGGCTACAGTAGTTTCTT
CGAACGCCTAATCATCGGCTATTT -> GAACGCCTAATCATCGGCTATTTG
CTTCAGTGGGCCCTGTTGTAGGAC -> TTCAGTGGGCCCTGTTGTAGGACT
TGCATCACGGTAACTGCTTACCTG -> GCATCACGGTAACTGCTTACCTGC
TCCATAGGAATGCGACGGAGCCCA -> CCATAGGAATGCGACGGAGCCCAG
TTACCTGCATAATTACCGTCTTTG -> TACCTGCATAATTACCGTCTTTGC
CCCATTATTGGGATGGCCGCCCCA -> CCATTATTGGGATGGCCGCCCCAC
CCTAATCATCGGCTATTTGGTAAG -> CTAATCATCGGCTATTTGGTAAGT
GCCCTGTTGTAGGACTGTATATCC -> CCCTGTTGTAGGACTGTATATCCC
TGAACGCGGCAAGGGGTTAGATAA -> GAACGCGGCAAGGGGTTAGATAAT
TGAAAAGCTGGTCTGTCTTACGAC -> GAAAAGCTGGTCTGTCTTACGACC
CGGCCGCAGTTGGGTATGCTTTCC -> GGCCGCAGTTGGGTATGCTTTCCT
CTTTGCTCACGAATCTTCACCTCA -> TTTGCTCACGAATCTTCACCTCAT
AAAGAAGTTGTCGAGCCTCTGTTG -> AAGAAGTTGTCGAGCCTCTGTTGA
TAGGACTTTGCTACTAGCTTCTCT -> AGGACTTTGCTACTAGCTTCTCTC
TAGAGCCACATACTGAAACCCGGG -> AGAGCCACATACTGAAACCCGGGC
TCCTGTGTGTTGCTATGGCCCGCT -> CCTGTGTGTTGCTATGGCCCGCTT
ATGTTAAGTCTGTCACCTTACCAA -> TGTTAAGTCTGTCACCTTACCAAG
TCACATCGTGGAGTGGACTCTTAA -> CACATCGTGGAGTGGACTCTTAAA
CCAAGAAGACATACATTCTTTGCA -> CAAGAAGACATACATTCTTTGCAC
AGTATGTATTGGCCCCAAGCAGTG -> GTATGTATTGGCCCCAAGCAGTGC
TACTAGCTTCTCTCTTCATCAGTC -> ACTAGCTTCTCTCTTCATCAGTCC
CTCTAATAGTGTAAGAAGTGCAGG -> TCTAATAGTGTAAGAAGTGCAGGC
TAGGAGGCTAGGGGCATACCACAG -> AGGAGGCTAGGGGCATACCACAGA
CATCTTACTCCTGTGTGTTGCTAT -> ATCTTACTCCTGTGTGTTGCTATG
CCACCGACCAGTCAAGACTCTAAT -> CACCGACCAGTCAAGACTCTAATA
TGAACAAAGCAGGAATATGCTGAA -> GAACAAAGCAGGAATATGCTGAAA
TTGAGCAACTACCCCATTATTGGG -> TGAGCAACTACCCCATTATTGGGA
CCCCACGGATCTGGGATGCTTTCT -> CCCACGGATCTGGGATGCTTTCTC
TTCAGAGGCGGCGGTATACGTTTA -> TCAGAGGCGGCGGTATACGTTTAT
ACCAAACGATGAGCTGCAGGGATG -> CCAAACGATGAGCTGCAGGGATGC
CGCAAAAATACCCTGACGAAACAC -> GCAAAAATACCCTGACGAAACACC
TTAGATAATGTCCATGGTCTCACA -> TAGATAATGTCCATGGTCTCACAT
GGGTTTAAAGTCGCCGCTTAGAAT -> GGTTTAAAGTCGCCGCTTAGAATG
ATTCTTTGCACATGTGAAGCCTAG -> TTCTTTGCACATGTGAAGCCTAGC
GTTAGGAGGCTAGGGGCATACCAC -> TTAGGAGGCTAGGGGCATACCACA
ATAACACTCTCCCGGACATTAGGC -> TAACACTCTCCCGGACATTAGGCC
CGTTTCATCTACAGAAAAAAATCT -> GTTTCATCTACAGAAAAAAATCTG
GGGTCACGTCGGGCCACCGGGCAT -> GGTCACGTCGGGCCACCGGGCATG
CGGCAAGGGGTTAGATAATGTCCA -> GGCAAGGGGTTAGATAATGTCCAT
TAGTTTCTTTTGCGGAGTGGATTC -> AGTTTCTTTTGCGGAGTGGATTCC
GTCCATGGTCTCACATCTGAGTTA -> TCCATGGTCTCACATCTGAGTTAG
ATTCCCTAAGGTACATTGCTGTGT -> TTCCCTAAGGTACATTGCTGTGTT
ACTTTGACCGCACTCCTATCACAA -> CTTTGACCGCACTCCTATCACAAC
CCGCACTCCTATCACAACGGCATA -> CGCACTCCTATCACAACGGCATAG
GTAAGATGGGCACCAACTGTGGGT -> TAAGATGGGCACCAACTGTGGGTT
ACCAACTGTGGGTTTAAAGTCGCC -> CCAACTGTGGGTTTAAAGTCGCCG
TCGTGGAGTGGACTCTTAAAACCT -> CGTGGAGTGGACTCTTAAAACCTG
CTTCTAACACCCGTGTTCTCTTCC -> TTCTAACACCCGTGTTCTCTTCCA
ATGTGCACTCGGACCGAGCGACCT -> TGTGCACTCGGACCGAGCGACCTC
CTCCTTGGCAAACTCGGGCGTTCC -> TCCTTGGCAAACTCGGGCGTTCCG
CTTACGACCGGCGGTCCGAGCTAA -> TTACGACCGGCGGTCCGAGCTAAT
CATTGGGTAACTGTTCTACGCTGG -> ATTGGGTAACTGTTCTACGCTGGG
GGCTTTTCTACGGCTCACACAGAG -> GCTTTTCTACGGCTCACACAGAGC
AAGCAGTGCCAGACTTGACGTCTT -> AGCAGTGCCAGACTTGACGTCTTA
AGTGGCAAATCACTTGCATCACGG -> GTGGCAAATCACTTGCATCACGGT
CCGATCCCCTGTTAGGCCCCTTTT -> CGATCCCCTGTTAGGCCCCTTTTC
CTGTCACCTTACCAAGCAGTTAGT -> TGTCACCTTACCAAGCAGTTAGTT
CATCACGGTAACTGCTTACCTGCA -> ATCACGGTAACTGCTTACCTGCAT
GGGATTCACGTTGTAAATCCACTC -> GGATTCACGTTGTAAATCCACTCA
CTCGGGCGTTCCGGCCGCCCGCGA -> TCGGGCGTTCCGGCCGCCCGCGAA
CCAAACGATGAGCTGCAGGGATGC -> CAAACGATGAGCTGCAGGGATGCA
TAATCCTGCCTTCAGCCCCTGCGG -> AATCCTGCCTTCAGCCCCTGCGGC
TATCCCCCCTCATGAGTCACCATT -> ATCCCCCCTCATGAGTCACCATTC
TTGTTTGGTCGTGGCCACCGACCA -> TGTTTGGTCGTGGCCACCGACCAG
GTCAAGACTCTAATAGTGTAAGAA -> TCAAGACTCTAATAGTGTAAGAAG
ATAGGAATGCGACGGAGCCCAGTT -> TAGGAATGCGACGGAGCCCAGTTA
CGGCTACAGTGGGATTCACGTTGT -> GGCTACAGTGGGATTCACGTTGTA
TGGCCGTTACCAAACTTGCCCGGC -> GGCCGTTACCAAACTTGCCCGGCC
GGATACACCTGAGATGCGCCCGAA -> GATACACCTGAGATGCGCCCGAAC
TTTAAGACGTAACCCAGACCGCCC -> TTAAGACGTAACCCAGACCGCCCA
TTTGGTCGTGGCCACCGACCAGTC -> TTGGTCGTGGCCACCGACCAGTCA
GAAAGAAGTTGTCGAGCCTCTGTT -> AAAGAAGTTGTCGAGCCTCTGTTG
GGTCTCACATCTGAGTTAGCAACG -> GTCTCACATCTGAGTTAGCAACGT
GTCTAGGCAGCTCGGAGTGTCTGT -> TCTAGGCAGCTCGGAGTGTCTGTT
AGTAAGATGGGCACCAACTGTGGG -> GTAAGATGGGCACCAACTGTGGGT
ACAAATCTTTTTAAGCCAGAACAT -> CAAATCTTTTTAAGCCAGAACATG
AGGAATGCGACGGAGCCCAGTTAT -> GGAATGCGACGGAGCCCAGTTATC
TTTAAGCCAGAACATGAACAAAGC -> TTAAGCCAGAACATGAACAAAGCA
GCATCACGGTAACTGCTTACCTGC -> CATCACGGTAACTGCTTACCTGCA
TTCCTACAATCCTGAGCGGGGGTA -> TCCTACAATCCTGAGCGGGGGTAC
CGGCCGCCCGCGAAGCCCTACTAA -> GGCCGCCCGCGAAGCCCTACTAAC
GATGCTTTCTCGCCGTTTTAAGAC -> ATGCTTTCTCGCCGTTTTAAGACG
GACTGTATATCCCCCCTCATGAGT -> ACTGTATATCCCCCCTCATGAGTC
TACGGAAAGAAGTTGTCGAGCCTC -> ACGGAAAGAAGTTGTCGAGCCTCT
GCTGCAGCCGGACGGCGTCCTCCA -> CTGCAGCCGGACGGCGTCCTCCAT
TACCGGGACCGGGACTTTGACCGC -> ACCGGGACCGGGACTTTGACCGCA
ACCCGTGTTCTCTTCCAGGAAACT -> CCCGTGTTCTCTTCCAGGAAACTA
GAGGCTAGGGGCATACCACAGACT -> AGGCTAGGGGCATACCACAGACTA
TTGACGTCTTAGACTACGGGAACT -> TGACGTCTTAGACTACGGGAACTA
TGTCCCCGACGGACATACACAATG -> GTCCCCGACGGACATACACAATGT
CAACTACCCCATTATTGGGATGGC -> AACTACCCCATTATTGGGATGGCC
GGCCACCGACCAGTCAAGACTCTA -> GCCACCGACCAGTCAAGACTCTAA
GTTAGCAACGTAGCCTCTCAAGAT -> TTAGCAACGTAGCCTCTCAAGATA
CCGCGAAGCCCTACTAACGGCCTC -> CGCGAAGCCCTACTAACGGCCTCA
CTTTTTGTCATGAACGCGGCAAGG -> TTTTTGTCATGAACGCGGCAAGGG
TGCTTACCTGCATAATTACCGTCT -> GCTTACCTGCATAATTACCGTCTT
GGGACTGGCTAAGGTCCGATAAGG -> GGACTGGCTAAGGTCCGATAAGGT
GAATGAAGTGGCAAATCACTTGCA -> AATGAAGTGGCAAATCACTTGCAT
CCCGTGTTCTCTTCCAGGAAACTA -> CCGTGTTCTCTTCCAGGAAACTAT
TTCATCAGTCCGTACGCCCGACCG -> TCATCAGTCCGTACGCCCGACCGA
GACGGAGCCCAGTTATCCTTTCCT -> ACGGAGCCCAGTTATCCTTTCCTA
TGTGAAGCCTAGCATACGTTTCAT -> GTGAAGCCTAGCATACGTTTCATC
AGTTATCCTTTCCTACAATCCTGA -> GTTATCCTTTCCTACAATCCTGAG
GCTACAGTGGGATTCACGTTGTAA -> CTACAGTGGGATTCACGTTGTAAA
GCACTTCAGTGGGCCCTGTTGTAG -> CACTTCAGTGGGCCCTGTTGTAGG
CTGTGGGTTTAAAGTCGCCGCTTA -> TGTGGGTTTAAAGTCGCCGCTTAG
ACCGACCAGTCAAGACTCTAATAG -> CCGACCAGTCAAGACTCTAATAGT
CCGACGGACATACACAATGTGTTT -> CGACGGACATACACAATGTGTTTT
TCAAGACTCTAATAGTGTAAGAAG -> CAAGACTCTAATAGTGTAAGAAGT
ACGGACGTCTCATGCAATCTGCCG -> CGGACGTCTCATGCAATCTGCCGT
AATCATCGGCTATTTGGTAAGTTG -> ATCATCGGCTATTTGGTAAGTTGT
TACATCTTACTCCTGTGTGTTGCT -> ACATCTTACTCCTGTGTGTTGCTA
GGACTTTGCTACTAGCTTCTCTCT -> GACTTTGCTACTAGCTTCTCTCTT
CGAGCTAATGTCGCTTCATGGTCT -> GAGCTAATGTCGCTTCATGGTCTG
AAGTCATAGAGCCACATACTGAAA -> AGTCATAGAGCCACATACTGAAAC
CTTATAGTGGCAAGGCTACAGTAG -> TTATAGTGGCAAGGCTACAGTAGT
TAATTCAGACCGCCAACCAAACGA -> AATTCAGACCGCCAACCAAACGAT
ACCAAGCAGTTAGTTAGGAGGCTA -> CCAAGCAGTTAGTTAGGAGGCTAG
CCTCATTCCGTGTTGTCCTGATAG -> CTCATTCCGTGTTGTCCTGATAGT
TCTTCCAGGAAACTATGCCAGACG -> CTTCCAGGAAACTATGCCAGACGG
AGGCTACAGTAGTTTCTTTTGCGG -> GGCTACAGTAGTTTCTTTTGCGGA
CCGTACGCCCGACCGAAGCGATTC -> CGTACGCCCGACCGAAGCGATTCC
TCTCGCCGTTTTAAGACGTAACCC -> CTCGCCGTTTTAAGACGTAACCCA
TCTCACATCTGAGTTAGCAACGTA -> CTCACATCTGAGTTAGCAACGTAG
TCTACAGAAAAAAATCTGTGCATA -> CTACAGAAAAAAATCTGTGCATAA
CGCCCATGGGTCACGTCGGGCCAC -> GCCCATGGGTCACGTCGGGCCACC
TCGGCTATTTGGTAAGTTGTCCCC -> CGGCTATTTGGTAAGTTGTCCCCG
TGGGATGGCCGCCCCACGGATCTG -> GGGATGGCCGCCCCACGGATCTGG
TAAAGATGGCCGTTACCAAACTTG -> AAAGATGGCCGTTACCAAACTTGC
AAGCGCCCATGGGTCACGTCGGGC -> AGCGCCCATGGGTCACGTCGGGCC
CACAATGTGTTTTGGTATCCAGAC -> ACAATGTGTTTTGGTATCCAGACA
AAAGTTCAGAGGCGGCGGTATACG -> AAGTTCAGAGGCGGCGGTATACGT
TATTGGGATGGCCGCCCCACGGAT -> ATTGGGATGGCCGCCCCACGGATC
ATTCCGTGTTGTCCTGATAGTACG -> TTCCGTGTTGTCCTGATAGTACGG
CGGAGTGGATTCCCTACCGGGACC -> GGAGTGGATTCCCTACCGGGACCG
CTTAGAATGCATTCAGTATACATC -> TTAGAATGCATTCAGTATACATCT
AGACCGCCAACCAAACGATGAGCT -> GACCGCCAACCAAACGATGAGCTG
ATCCCCTGTTAGGCCCCTTTTCAT -> TCCCCTGTTAGGCCCCTTTTCATT
GCTGGTCTGTCTTACGACCGGCGG -> CTGGTCTGTCTTACGACCGGCGGT
TGAGTTAGCAACGTAGCCTCTCAA -> GAGTTAGCAACGTAGCCTCTCAAG
TCTTTTTGTCATGAACGCGGCAAG -> CTTTTTGTCATGAACGCGGCAAGG
GTTGGGTATGCTTTCCTGTGCGAA -> TTGGGTATGCTTTCCTGTGCGAAG
CGCACTCCTATCACAACGGCATAG -> GCACTCCTATCACAACGGCATAGT
CGTAACCCAGACCGCCCAGTAGCA -> GTAACCCAGACCGCCCAGTAGCAC
TCATGAACGCGGCAAGGGGTTAGA -> CATGAACGCGGCAAGGGGTTAGAT
ACAGAGCGAAGTTCCAATTCCAAC -> CAGAGCGAAGTTCCAATTCCAACT
GACTTTGCTACTAGCTTCTCTCTT -> ACTTTGCTACTAGCTTCTCTCTTC
GAACGCGGCAAGGGGTTAGATAAT -> AACGCGGCAAGGGGTTAGATAATG
ATGTGTTTTGGTATCCAGACATGT -> TGTGTTTTGGTATCCAGACATGTG
CTCTCCCGGACATTAGGCCCCCCG -> TCTCCCGGACATTAGGCCCCCCGG
TCTGTGCATAACACTCTCCCGGAC -> CTGTGCATAACACTCTCCCGGACA
GGCAAATCACTTGCATCACGGTAA -> GCAAATCACTTGCATCACGGTAAC
TCAGTATACATCTTACTCCTGTGT -> CAGTATACATCTTACTCCTGTGTG
ACAACGGCATAGTCAATTGTATCC -> CAACGGCATAGTCAATTGTATCCC
CGGTAACTGCTTACCTGCATAATT -> GGTAACTGCTTACCTGCATAATTA
CTCACACAGAGCGAAGTTCCAATT -> TCACACAGAGCGAAGTTCCAATTC
TTGCAAGTCATAGAGCCACATACT -> TGCAAGTCATAGAGCCACATACTG
CCCAGTAGCACTCAATGTCGGGTA -> CCAGTAGCACTCAATGTCGGGTAT
CTCTTAAAACCTGACTTGAGTGTA -> TCTTAAAACCTGACTTGAGTGTAG
CTGGATTGGTGAATAACACATCAA -> TGGATTGGTGAATAACACATCAAG
ACAGCTATGATCATGGCAGTGGGT -> CAGCTATGATCATGGCAGTGGGTA
CTGGGATCAACACGGATATACGCG -> TGGGATCAACACGGATATACGCGA
CCGAGCGACCTCCACCTGTAAGAA -> CGAGCGACCTCCACCTGTAAGAAA
CCGTGTTCTCGGAGTAGCTAGTAC -> CGTGTTCTCGGAGTAGCTAGTACC
ACATACACAATGTGTTTTGGTATC -> CATACACAATGTGTTTTGGTATCC
CTGTCACTTTGATCAGAGTAAGAT -> TGTCACTTTGATCAGAGTAAGATG
AAGTCGCCGCTTAGAATGCATTCA -> AGTCGCCGCTTAGAATGCATTCAG
AGATACTTATGTCTTACATGGATC -> GATACTTATGTCTTACATGGATCA
TTTTAAGACGTAACCCAGACCGCC -> TTTAAGACGTAACCCAGACCGCCC
CATTCTTTGCACATGTGAAGCCTA -> ATTCTTTGCACATGTGAAGCCTAG
GAAACTATGCCAGACGGACGTCTC -> AAACTATGCCAGACGGACGTCTCA
GCCTCCATTCCCTAAGGTACATTG -> CCTCCATTCCCTAAGGTACATTGC
GGTCCGATAAGGTGCGGCAGATGG -> GTCCGATAAGGTGCGGCAGATGGG
CCTTACCAAGCAGTTAGTTAGGAG -> CTTACCAAGCAGTTAGTTAGGAGG
GAGTGGATTCCCTACCGGGACCGG -> AGTGGATTCCCTACCGGGACCGGG
GCACTCCTATCACAACGGCATAGT -> CACTCCTATCACAACGGCATAGTC
CAGGAAACTATGCCAGACGGACGT -> AGGAAACTATGCCAGACGGACGTC
GATCAAGTATCTCTGTGACCACGT -> ATCAAGTATCTCTGTGACCACGTC
CTACCGGGACCGGGACTTTGACCG -> TACCGGGACCGGGACTTTGACCGC
TTACCAAGCAGTTAGTTAGGAGGC -> TACCAAGCAGTTAGTTAGGAGGCT
GACTCTAATAGTGTAAGAAGTGCA -> ACTCTAATAGTGTAAGAAGTGCAG
AGCAGTGCCAGACTTGACGTCTTA -> GCAGTGCCAGACTTGACGTCTTAG
CCAACTGTGGGTTTAAAGTCGCCG -> CAACTGTGGGTTTAAAGTCGCCGC
CTCACGAATCTTCACCTCATTCCG -> TCACGAATCTTCACCTCATTCCGT
GTTCCGGCCGCCCGCGAAGCCCTA -> TTCCGGCCGCCCGCGAAGCCCTAC
CTAAGGTCCGATAAGGTGCGGCAG -> TAAGGTCCGATAAGGTGCGGCAGA
GGAGTGTCTGTTGCTGCAGCCGGA -> GAGTGTCTGTTGCTGCAGCCGGAC
CGAAGATTCCTTAATTCAGACCGC -> GAAGATTCCTTAATTCAGACCGCC
TACTCACATCGTGGAGTGGACTCT -> ACTCACATCGTGGAGTGGACTCTT
CCCCAAGCAGTGCCAGACTTGACG -> CCCAAGCAGTGCCAGACTTGACGT
AACGGCCTCAGGTGCCCTCATCGG -> ACGGCCTCAGGTGCCCTCATCGGC
TCCACTCAGTATGTATTGGCCCCA -> CCACTCAGTATGTATTGGCCCCAA
TTGGCAAACTCGGGCGTTCCGGCC -> TGGCAAACTCGGGCGTTCCGGCCG
CCCTAAGGTACATTGCTGTGTTGT -> CCTAAGGTACATTGCTGTGTTGTT
CCCGGGCAGGCGTCATACCGGGGA -> CCGGGCAGGCGTCATACCGGGGAT
TGGGTTTAAAGTCGCCGCTTAGAA -> GGGTTTAAAGTCGCCGCTTAGAAT
AATCACTTGCATCACGGTAACTGC -> ATCACTTGCATCACGGTAACTGCT
GAAGTGCAGGCGAGTAAAGATGGC -> AAGTGCAGGCGAGTAAAGATGGCC
CGTCCTCCATAGGAATGCGACGGA -> GTCCTCCATAGGAATGCGACGGAG
TATCACAACGGCATAGTCAATTGT -> ATCACAACGGCATAGTCAATTGTA
TATAGTGGCAAGGCTACAGTAGTT -> ATAGTGGCAAGGCTACAGTAGTTT
GCGGCTTATAGTGGCAAGGCTACA -> CGGCTTATAGTGGCAAGGCTACAG
CAGTTGGGTATGCTTTCCTGTGCG -> AGTTGGGTATGCTTTCCTGTGCGA
GACATGTGCACTCGGACCGAGCGA -> ACATGTGCACTCGGACCGAGCGAC
GCGGGGGTACTCATAAGTTGGCAC -> CGGGGGTACTCATAAGTTGGCACG
AATGTCCATGGTCTCACATCTGAG -> ATGTCCATGGTCTCACATCTGAGT
CGAATGAAGTGGCAAATCACTTGC -> GAATGAAGTGGCAAATCACTTGCA
ACCTCATTCCGTGTTGTCCTGATA -> CCTCATTCCGTGTTGTCCTGATAG
CTGTGTTGTTTGGTCGTGGCCACC -> TGTGTTGTTTGGTCGTGGCCACCG
GTTAGATAATGTCCATGGTCTCAC -> TTAGATAATGTCCATGGTCTCACA
CACGGATATACGCGATCCTGCCGA -> ACGGATATACGCGATCCTGCCGAA
CATTTAGGACTTTGCTACTAGCTT -> ATTTAGGACTTTGCTACTAGCTTC
AGCGCGCCCTCAATCAGCATTCCG -> GCGCGCCCTCAATCAGCATTCCGA
CCCCGACGGACATACACAATGTGT -> CCCGACGGACATACACAATGTGTT
GTTCCAATTCCAACTGCAGTAACT -> TTCCAATTCCAACTGCAGTAACTG
TTAAAGTCGCCGCTTAGAATGCAT -> TAAAGTCGCCGCTTAGAATGCATT
TCCTGATAGTACGGAAAGAAGTTG -> CCTGATAGTACGGAAAGAAGTTGT
AATTCCAACTGCAGTAACTGGAGG -> ATTCCAACTGCAGTAACTGGAGGA
CATGTTGAAAAAAATGAGCGTGTT -> ATGTTGAAAAAAATGAGCGTGTTA
ATATCCCCCCTCATGAGTCACCAT -> TATCCCCCCTCATGAGTCACCATT
CCAGACGGACGTCTCATGCAATCT -> CAGACGGACGTCTCATGCAATCTG
CGGACGGCGTCCTCCATAGGAATG -> GGACGGCGTCCTCCATAGGAATGC
AGAATGCATTCAGTATACATCTTA -> GAATGCATTCAGTATACATCTTAC
AAAATCTGTGCATAACACTCTCCC -> AAATCTGTGCATAACACTCTCCCG
TTAAGACGTAACCCAGACCGCCCA -> TAAGACGTAACCCAGACCGCCCAG
CAAATCTTTTTAAGCCAGAACATG -> AAATCTTTTTAAGCCAGAACATGA
TAAGAAAAGTTCAGAGGCGGCGGT -> AAGAAAAGTTCAGAGGCGGCGGTA
AGGTGCGGCAGATGGGAGTGTTAG -> GGTGCGGCAGATGGGAGTGTTAGC
TTCACCTCATTCCGTGTTGTCCTG -> TCACCTCATTCCGTGTTGTCCTGA
TGACTTGAGTGTAGGCCTGTCACT -> GACTTGAGTGTAGGCCTGTCACTT
CTGCTTACCTGCATAATTACCGTC -> TGCTTACCTGCATAATTACCGTCT
TAAAGTCGCCGCTTAGAATGCATT -> AAAGTCGCCGCTTAGAATGCATTC
TCCCCCCTCATGAGTCACCATTCT -> CCCCCCTCATGAGTCACCATTCTT
GGCTACAGTGGGATTCACGTTGTA -> GCTACAGTGGGATTCACGTTGTAA
CAGATGGGAGTGTTAGCAAGCGCC -> AGATGGGAGTGTTAGCAAGCGCCC
CGCGGCAAGGGGTTAGATAATGTC -> GCGGCAAGGGGTTAGATAATGTCC
GAAGCGCGCCCTCAATCAGCATTC -> AAGCGCGCCCTCAATCAGCATTCC
CATGGCAGTGGGTAGTCTAGGCAG -> ATGGCAGTGGGTAGTCTAGGCAGC
TCTTACGACCGGCGGTCCGAGCTA -> CTTACGACCGGCGGTCCGAGCTAA
GAATGCGACGGAGCCCAGTTATCC -> AATGCGACGGAGCCCAGTTATCCT
TTCCTGTGCGAAGATTCCTTAATT -> TCCTGTGCGAAGATTCCTTAATTC
AAATGAGCGTGTTACTCACATCGT -> AATGAGCGTGTTACTCACATCGTG
CAAGCAGTTAGTTAGGAGGCTAGG -> AAGCAGTTAGTTAGGAGGCTAGGG
GTTTATGCAGCGACCAGCATTGGG -> TTTATGCAGCGACCAGCATTGGGT
CCGAAACATCCATGTTGAAAAAAA -> CGAAACATCCATGTTGAAAAAAAT
ACGTAACCCAGACCGCCCAGTAGC -> CGTAACCCAGACCGCCCAGTAGCA
GTGGACTCTTAAAACCTGACTTGA -> TGGACTCTTAAAACCTGACTTGAG
AAAAATACCCTGACGAAACACCAT -> AAAATACCCTGACGAAACACCATT
CCTGTGTGTTGCTATGGCCCGCTT -> CTGTGTGTTGCTATGGCCCGCTTG
CTATGATCATGGCAGTGGGTAGTC -> TATGATCATGGCAGTGGGTAGTCT
GAGTAGCTAGTACCTGGTACTGCG -> AGTAGCTAGTACCTGGTACTGCGC
GGGATGCACTTCAGTGGGCCCTGT -> GGATGCACTTCAGTGGGCCCTGTT
GTGTTCTCTTCCAGGAAACTATGC -> TGTTCTCTTCCAGGAAACTATGCC
GGACCGAGCGACCTCCACCTGTAA -> GACCGAGCGACCTCCACCTGTAAG
CTTGCCCGGCCCTCCTTGGCAAAC -> TTGCCCGGCCCTCCTTGGCAAACT
TCACATCTGAGTTAGCAACGTAGC -> CACATCTGAGTTAGCAACGTAGCC
TTCTTTGCACATGTGAAGCCTAGC -> TCTTTGCACATGTGAAGCCTAGCA
CCTGAGATGCGCCCGAACGCCTAA -> CTGAGATGCGCCCGAACGCCTAAT
CGGCTATTTGGTAAGTTGTCCCCG -> GGCTATTTGGTAAGTTGTCCCCGA
GTGCCCTCATCGGCAGATTGCAAG -> TGCCCTCATCGGCAGATTGCAAGT
AGAAAAGTTCAGAGGCGGCGGTAT -> GAAAAGTTCAGAGGCGGCGGTATA
CTGTCAGACACACCGATCCCCTGT -> TGTCAGACACACCGATCCCCTGTT
GGTATGGGCTTTTCTACGGCTCAC -> GTATGGGCTTTTCTACGGCTCACA
TCGGAGTAGCTAGTACCTGGTACT -> CGGAGTAGCTAGTACCTGGTACTG
GTTTAAAGTCGCCGCTTAGAATGC -> TTTAAAGTCGCCGCTTAGAATGCA
CATACCGGGGATACACCTGAGATG -> ATACCGGGGATACACCTGAGATGC
CAGGAATATGCTGAAATGAAAAGC -> AGGAATATGCTGAAATGAAAAGCT
AGCCCCTGCGGCTTATAGTGGCAA -> GCCCCTGCGGCTTATAGTGGCAAG
GACCCAAGAAGACATACATTCTTT -> ACCCAAGAAGACATACATTCTTTG
TTCTCTTCCAGGAAACTATGCCAG -> TCTCTTCCAGGAAACTATGCCAGA
ATGAACAAAGCAGGAATATGCTGA -> TGAACAAAGCAGGAATATGCTGAA
AGCGATTCCTATTACCTCTGTCAG -> GCGATTCCTATTACCTCTGTCAGA
GCCCCCCGGCTACAGTGGGATTCA -> CCCCCCGGCTACAGTGGGATTCAC
TTTCATCTACAGAAAAAAATCTGT -> TTCATCTACAGAAAAAAATCTGTG
GATAAGGTGCGGCAGATGGGAGTG -> ATAAGGTGCGGCAGATGGGAGTGT
GTGTAGGCCTGTCACTTTGATCAG -> TGTAGGCCTGTCACTTTGATCAGA
AATATGCTGAAATGAAAAGCTGGT -> ATATGCTGAAATGAAAAGCTGGTC
TTGGGATGGCCGCCCCACGGATCT -> TGGGATGGCCGCCCCACGGATCTG
CACTCTCCCGGACATTAGGCCCCC -> ACTCTCCCGGACATTAGGCCCCCC
GTACGCCCGACCGAAGCGATTCCT -> TACGCCCGACCGAAGCGATTCCTA
TTTGCTACTAGCTTCTCTCTTCAT -> TTGCTACTAGCTTCTCTCTTCATC
CAATGTCGGGTATGACCCAAGAAG -> AATGTCGGGTATGACCCAAGAAGA
AGCGTGTTACTCACATCGTGGAGT -> GCGTGTTACTCACATCGTGGAGTG
GGATTCCCTACCGGGACCGGGACT -> GATTCCCTACCGGGACCGGGACTT
GCTGCAGGGATGCACTTCAGTGGG -> CTGCAGGGATGCACTTCAGTGGGC
CGCCCGCGAAGCCCTACTAACGGC -> GCCCGCGAAGCCCTACTAACGGCC
GCCACCGGGCATGTTAAGTCTGTC -> CCACCGGGCATGTTAAGTCTGTCA
CGCCAACCAAACGATGAGCTGCAG -> GCCAACCAAACGATGAGCTGCAGG
GAGTGGACTCTTAAAACCTGACTT -> AGTGGACTCTTAAAACCTGACTTG
AGAGCGAAGTTCCAATTCCAACTG -> GAGCGAAGTTCCAATTCCAACTGC
CGCCCTCAATCAGCATTCCGACTA -> GCCCTCAATCAGCATTCCGACTAC
GGAGTAGCTAGTACCTGGTACTGC -> GAGTAGCTAGTACCTGGTACTGCG
GTCCTCCATAGGAATGCGACGGAG -> TCCTCCATAGGAATGCGACGGAGC
ATCCATGTTGAAAAAAATGAGCGT -> TCCATGTTGAAAAAAATGAGCGTG
GGCCCCAAGCAGTGCCAGACTTGA -> GCCCCAAGCAGTGCCAGACTTGAC
TGTCGGGTATGACCCAAGAAGACA -> GTCGGGTATGACCCAAGAAGACAT
GCAACTACCCCATTATTGGGATGG -> CAACTACCCCATTATTGGGATGGC
CGTCATACCGGGGATACACCTGAG -> GTCATACCGGGGATACACCTGAGA
GAGGAAGCGCGCCCTCAATCAGCA -> AGGAAGCGCGCCCTCAATCAGCAT
CAGGTGCCCTCATCGGCAGATTGC -> AGGTGCCCTCATCGGCAGATTGCA
ACTCTCCCGGACATTAGGCCCCCC -> CTCTCCCGGACATTAGGCCCCCCG
TGCACTCGGACCGAGCGACCTCCA -> GCACTCGGACCGAGCGACCTCCAC
TCTCTCTTCATCAGTCCGTACGCC -> CTCTCTTCATCAGTCCGTACGCCC
CCTGACGAAACACCATTTAGGACT -> CTGACGAAACACCATTTAGGACTT
CAGGGATGCACTTCAGTGGGCCCT -> AGGGATGCACTTCAGTGGGCCCTG
CGGGCATGTTAAGTCTGTCACCTT -> GGGCATGTTAAGTCTGTCACCTTA
GCAGGGATGCACTTCAGTGGGCCC -> CAGGGATGCACTTCAGTGGGCCCT
TTCCAGGAAACTATGCCAGACGGA -> TCCAGGAAACTATGCCAGACGGAC
GCGACCTCCACCTGTAAGAAAAGT -> CGACCTCCACCTGTAAGAAAAGTT
TATGTCTTACATGGATCAAGTATC -> ATGTCTTACATGGATCAAGTATCT
CAATCCTGAGCGGGGGTACTCATA -> AATCCTGAGCGGGGGTACTCATAA
TCAGTCCGTACGCCCGACCGAAGC -> CAGTCCGTACGCCCGACCGAAGCG
ACCGATCCCCTGTTAGGCCCCTTT -> CCGATCCCCTGTTAGGCCCCTTTT
GGGCCACCGGGCATGTTAAGTCTG -> GGCCACCGGGCATGTTAAGTCTGT
TCCGACTACACAGCTATGATCATG -> CCGACTACACAGCTATGATCATGG
CAGTCAAGACTCTAATAGTGTAAG -> AGTCAAGACTCTAATAGTGTAAGA
CCTAAGGTACATTGCTGTGTTGTT -> CTAAGGTACATTGCTGTGTTGTTT
CCATTATTGGGATGGCCGCCCCAC -> CATTATTGGGATGGCCGCCCCACG
GGACCGGGACTTTGACCGCACTCC -> GACCGGGACTTTGACCGCACTCCT
CATGAACAAAGCAGGAATATGCTG -> ATGAACAAAGCAGGAATATGCTGA
TCTAATAGTGTAAGAAGTGCAGGC -> CTAATAGTGTAAGAAGTGCAGGCG
GGGACTTTGACCGCACTCCTATCA -> GGACTTTGACCGCACTCCTATCAC
GCACATGTGAAGCCTAGCATACGT -> CACATGTGAAGCCTAGCATACGTT
GTGCCAGACTTGACGTCTTAGACT -> TGCCAGACTTGACGTCTTAGACTA
TGAAGTGGCAAATCACTTGCATCA -> GAAGTGGCAAATCACTTGCATCAC
GATCTGGGATGCTTTCTCGCCGTT -> ATCTGGGATGCTTTCTCGCCGTTT
CCACCTGTAAGAAAAGTTCAGAGG -> CACCTGTAAGAAAAGTTCAGAGGC
TTAGGAGGCTAGGGGCATACCACA -> TAGGAGGCTAGGGGCATACCACAG
AAAGCTGGTCTGTCTTACGACCGG -> AAGCTGGTCTGTCTTACGACCGGC
GCTCACGAATCTTCACCTCATTCC -> CTCACGAATCTTCACCTCATTCCG
GGGCGTTCCGGCCGCCCGCGAAGC -> GGCGTTCCGGCCGCCCGCGAAGCC
GTCGTGGCCACCGACCAGTCAAGA -> TCGTGGCCACCGACCAGTCAAGAC
AGTACCTGGTACTGCGCCGTCGGA -> GTACCTGGTACTGCGCCGTCGGAC
CACGGTAACTGCTTACCTGCATAA -> ACGGTAACTGCTTACCTGCATAAT
TGTCCTGATAGTACGGAAAGAAGT -> GTCCTGATAGTACGGAAAGAAGTT
GGACATTAGGCCCCCCGGCTACAG -> GACATTAGGCCCCCCGGCTACAGT
TCTGTGACCACGTCATTGCGGCCG -> CTGTGACCACGTCATTGCGGCCGC
TTGCACATGTGAAGCCTAGCATAC -> TGCACATGTGAAGCCTAGCATACG
GACTACGGGAACTAATCCTGCCTT -> ACTACGGGAACTAATCCTGCCTTC
AAGTGGCAAATCACTTGCATCACG -> AGTGGCAAATCACTTGCATCACGG
ATTCCAACTGCAGTAACTGGAGGA -> TTCCAACTGCAGTAACTGGAGGAA
CCAGACCGCCCAGTAGCACTCAAT -> CAGACCGCCCAGTAGCACTCAATG
ATTCAGTATACATCTTACTCCTGT -> TTCAGTATACATCTTACTCCTGTG
AGTGGGTAGTCTAGGCAGCTCGGA -> GTGGGTAGTCTAGGCAGCTCGGAG
AAGTGCAGGCGAGTAAAGATGGCC -> AGTGCAGGCGAGTAAAGATGGCCG
CTCTGTGACCACGTCATTGCGGCC -> TCTGTGACCACGTCATTGCGGCCG
AACTGTGGGTTTAAAGTCGCCGCT -> ACTGTGGGTTTAAAGTCGCCGCTT
GACTTGACGTCTTAGACTACGGGA -> ACTTGACGTCTTAGACTACGGGAA
ACGCTTCGGGGACTGGCTAAGGTC -> CGCTTCGGGGACTGGCTAAGGTCC
CGAAACATCCATGTTGAAAAAAAT -> GAAACATCCATGTTGAAAAAAATG
GTAGGACTGTATATCCCCCCTCAT -> TAGGACTGTATATCCCCCCTCATG
CACCTTACCAAGCAGTTAGTTAGG -> ACCTTACCAAGCAGTTAGTTAGGA
CTGTTAGGCCCCTTTTCATTTAGC -> TGTTAGGCCCCTTTTCATTTAGCT
CTGTCTTACGACCGGCGGTCCGAG -> TGTCTTACGACCGGCGGTCCGAGC
TTGCTACTAGCTTCTCTCTTCATC -> TGCTACTAGCTTCTCTCTTCATCA
GCGTTCCGGCCGCCCGCGAAGCCC -> CGTTCCGGCCGCCCGCGAAGCCCT
ATGGGAGTGTTAGCAAGCGCCCAT -> TGGGAGTGTTAGCAAGCGCCCATG
GGAAACTATGCCAGACGGACGTCT -> GAAACTATGCCAGACGGACGTCTC
AATGAGCGTGTTACTCACATCGTG -> ATGAGCGTGTTACTCACATCGTGG
CCAATTCCAACTGCAGTAACTGGA -> CAATTCCAACTGCAGTAACTGGAG
ATCTACAGAAAAAAATCTGTGCAT -> TCTACAGAAAAAAATCTGTGCATA
GGATGCACTTCAGTGGGCCCTGTT -> GATGCACTTCAGTGGGCCCTGTTG
CTCCATAGGAATGCGACGGAGCCC -> TCCATAGGAATGCGACGGAGCCCA
CACGTCGGGCCACCGGGCATGTTA -> ACGTCGGGCCACCGGGCATGTTAA
CCAGTAGCACTCAATGTCGGGTAT -> CAGTAGCACTCAATGTCGGGTATG
AGCGCCCATGGGTCACGTCGGGCC -> GCGCCCATGGGTCACGTCGGGCCA
AGGAATATGCTGAAATGAAAAGCT -> GGAATATGCTGAAATGAAAAGCTG
CCTTGGCAAACTCGGGCGTTCCGG -> CTTGGCAAACTCGGGCGTTCCGGC
TCACGAATCTTCACCTCATTCCGT -> CACGAATCTTCACCTCATTCCGTG
TGCCCGGCCCTCCTTGGCAAACTC -> GCCCGGCCCTCCTTGGCAAACTCG
AGTATCTCTGTGACCACGTCATTG -> GTATCTCTGTGACCACGTCATTGC
GCTTATAGTGGCAAGGCTACAGTA -> CTTATAGTGGCAAGGCTACAGTAG
TGACCCAAGAAGACATACATTCTT -> GACCCAAGAAGACATACATTCTTT
GCCGCCCCACGGATCTGGGATGCT -> CCGCCCCACGGATCTGGGATGCTT
TAGCTTCTCTCTTCATCAGTCCGT -> AGCTTCTCTCTTCATCAGTCCGTA
GATTCCTATTACCTCTGTCAGACA -> ATTCCTATTACCTCTGTCAGACAC
TCAAGATACTTATGTCTTACATGG -> CAAGATACTTATGTCTTACATGGA
CCCTCAATCAGCATTCCGACTACA -> CCTCAATCAGCATTCCGACTACAC
TAAGAAGTGCAGGCGAGTAAAGAT -> AAGAAGTGCAGGCGAGTAAAGATG
ACACCATTTAGGACTTTGCTACTA -> CACCATTTAGGACTTTGCTACTAG
CTTGACGTCTTAGACTACGGGAAC -> TTGACGTCTTAGACTACGGGAACT
GCGGCCGCAGTTGGGTATGCTTTC -> CGGCCGCAGTTGGGTATGCTTTCC
GCGCCGTCGGACTGAGGCCTCCAT -> CGCCGTCGGACTGAGGCCTCCATT
CCGACTACACAGCTATGATCATGG -> CGACTACACAGCTATGATCATGGC
TTTCTTTTGCGGAGTGGATTCCCT -> TTCTTTTGCGGAGTGGATTCCCTA
CTTCAGCCCCTGCGGCTTATAGTG -> TTCAGCCCCTGCGGCTTATAGTGG
TCGGGGACTGGCTAAGGTCCGATA -> CGGGGACTGGCTAAGGTCCGATAA
ATCATGGCAGTGGGTAGTCTAGGC -> TCATGGCAGTGGGTAGTCTAGGCA
ACGTCGGGCCACCGGGCATGTTAA -> CGTCGGGCCACCGGGCATGTTAAG
ACATGGATCAAGTATCTCTGTGAC -> CATGGATCAAGTATCTCTGTGACC
GAGCTAATGTCGCTTCATGGTCTG -> AGCTAATGTCGCTTCATGGTCTGG
ATGGGTCACGTCGGGCCACCGGGC -> TGGGTCACGTCGGGCCACCGGGCA
CAACGTAGCCTCTCAAGATACTTA -> AACGTAGCCTCTCAAGATACTTAT
CTGTTGAGGGGTATGGGCTTTTCT -> TGTTGAGGGGTATGGGCTTTTCTA
TCTTTGCTCACGAATCTTCACCTC -> CTTTGCTCACGAATCTTCACCTCA
TTATCCTTTCCTACAATCCTGAGC -> TATCCTTTCCTACAATCCTGAGCG
ATGGCAGTGGGTAGTCTAGGCAGC -> TGGCAGTGGGTAGTCTAGGCAGCT
TGCGGCTTATAGTGGCAAGGCTAC -> GCGGCTTATAGTGGCAAGGCTACA
CGCGATCCTGCCGAAACATCCATG -> GCGATCCTGCCGAAACATCCATGT
GAGTAAAGATGGCCGTTACCAAAC -> AGTAAAGATGGCCGTTACCAAACT
TTCCTTAATTCAGACCGCCAACCA -> TCCTTAATTCAGACCGCCAACCAA
AGGCAGCTCGGAGTGTCTGTTGCT -> GGCAGCTCGGAGTGTCTGTTGCTG
TCGGGCGTTCCGGCCGCCCGCGAA -> CGGGCGTTCCGGCCGCCCGCGAAG
GGGCATGTTAAGTCTGTCACCTTA -> GGCATGTTAAGTCTGTCACCTTAC
GCCGTTACCAAACTTGCCCGGCCC -> CCGTTACCAAACTTGCCCGGCCCT
CCACGGATCTGGGATGCTTTCTCG -> CACGGATCTGGGATGCTTTCTCGC
CTACAGAAAAAAATCTGTGCATAA -> TACAGAAAAAAATCTGTGCATAAC
CTTTTCATTTAGCTTTTCTTTTTG -> TTTTCATTTAGCTTTTCTTTTTGT
ACGGCGTCCTCCATAGGAATGCGA -> CGGCGTCCTCCATAGGAATGCGAC
GTCATAGAGCCACATACTGAAACC -> TCATAGAGCCACATACTGAAACCC
AACACTCTCCCGGACATTAGGCCC -> ACACTCTCCCGGACATTAGGCCCC
TCTGAGTTAGCAACGTAGCCTCTC -> CTGAGTTAGCAACGTAGCCTCTCA
ATCTGCCGTAACAAATCTTTTTAA -> TCTGCCGTAACAAATCTTTTTAAG
CTCAGTATGTATTGGCCCCAAGCA -> TCAGTATGTATTGGCCCCAAGCAG
TGTTGTAGGACTGTATATCCCCCC -> GTTGTAGGACTGTATATCCCCCCT
CGACCGAAGCGATTCCTATTACCT -> GACCGAAGCGATTCCTATTACCTC
CATTCCCTAAGGTACATTGCTGTG -> ATTCCCTAAGGTACATTGCTGTGT
CACCTGAGATGCGCCCGAACGCCT -> ACCTGAGATGCGCCCGAACGCCTA
ACTGTGGGTTTAAAGTCGCCGCTT -> CTGTGGGTTTAAAGTCGCCGCTTA
ACCGAGCGACCTCCACCTGTAAGA -> CCGAGCGACCTCCACCTGTAAGAA
TCACGGTAACTGCTTACCTGCATA -> CACGGTAACTGCTTACCTGCATAA
TATTACCTCTGTCAGACACACCGA -> ATTACCTCTGTCAGACACACCGAT
GGTGCCCTCATCGGCAGATTGCAA -> GTGCCCTCATCGGCAGATTGCAAG
AACCCAGACCGCCCAGTAGCACTC -> ACCCAGACCGCCCAGTAGCACTCA
CACGCTTCGGGGACTGGCTAAGGT -> ACGCTTCGGGGACTGGCTAAGGTC
AGCCGGACGGCGTCCTCCATAGGA -> GCCGGACGGCGTCCTCCATAGGAA
CACCGGGCATGTTAAGTCTGTCAC -> ACCGGGCATGTTAAGTCTGTCACC
TTACCAAACTTGCCCGGCCCTCCT -> TACCAAACTTGCCCGGCCCTCCTT
TTAGGACTTTGCTACTAGCTTCTC -> TAGGACTTTGCTACTAGCTTCTCT
ACCAGTCAAGACTCTAATAGTGTA -> CCAGTCAAGACTCTAATAGTGTAA
TGTCGAGCCTCTGTTGAGGGGTAT -> GTCGAGCCTCTGTTGAGGGGTATG
AGCCACATACTGAAACCCGGGCAG -> GCCACATACTGAAACCCGGGCAGG
TCGGACTGAGGCCTCCATTCCCTA -> CGGACTGAGGCCTCCATTCCCTAA
ACTATTGAGCAACTACCCCATTAT -> CTATTGAGCAACTACCCCATTATT
TTTAGGACTTTGCTACTAGCTTCT -> TTAGGACTTTGCTACTAGCTTCTC
GGGTAACTGTTCTACGCTGGGATC -> GGTAACTGTTCTACGCTGGGATCA
CCCAAGAAGACATACATTCTTTGC -> CCAAGAAGACATACATTCTTTGCA
CAGCATTCCGACTACACAGCTATG -> AGCATTCCGACTACACAGCTATGA
AATAGTGTAAGAAGTGCAGGCGAG -> ATAGTGTAAGAAGTGCAGGCGAGT
TTCTACGGCTCACACAGAGCGAAG -> TCTACGGCTCACACAGAGCGAAGT
CAGATTGCAAGTCATAGAGCCACA -> AGATTGCAAGTCATAGAGCCACAT
GCTTCATGGTCTGGATTGGTGAAT -> CTTCATGGTCTGGATTGGTGAATA
CTACTAGCTTCTCTCTTCATCAGT -> TACTAGCTTCTCTCTTCATCAGTC
AGGCGGCGGTATACGTTTATGCAG -> GGCGGCGGTATACGTTTATGCAGC
TGGCCACCGACCAGTCAAGACTCT -> GGCCACCGACCAGTCAAGACTCTA
GCCAGACTTGACGTCTTAGACTAC -> CCAGACTTGACGTCTTAGACTACG
CAGGCGAGTAAAGATGGCCGTTAC -> AGGCGAGTAAAGATGGCCGTTACC
AGTCTAGGCAGCTCGGAGTGTCTG -> GTCTAGGCAGCTCGGAGTGTCTGT
TAGGGGCATACCACAGACTATTGA -> AGGGGCATACCACAGACTATTGAG
CCATAGGAATGCGACGGAGCCCAG -> CATAGGAATGCGACGGAGCCCAGT
GCATTCCGACTACACAGCTATGAT -> CATTCCGACTACACAGCTATGATC
GGCAAGGCTACAGTAGTTTCTTTT -> GCAAGGCTACAGTAGTTTCTTTTG
CACCGACCAGTCAAGACTCTAATA -> ACCGACCAGTCAAGACTCTAATAG
AAACTCGGGCGTTCCGGCCGCCCG -> AACTCGGGCGTTCCGGCCGCCCGC
GTAAGAAAAGTTCAGAGGCGGCGG -> TAAGAAAAGTTCAGAGGCGGCGGT
GAAAAAAATCTGTGCATAACACTC -> AAAAAAATCTGTGCATAACACTCT
GCCCGCTTGCTGACGAACGAATGA -> CCCGCTTGCTGACGAACGAATGAA
CATAAGTTGGCACGCTTCTAACAC -> ATAAGTTGGCACGCTTCTAACACC
TTTTGGTATCCAGACATGTGCACT -> TTTGGTATCCAGACATGTGCACTC
GCAAAAATACCCTGACGAAACACC -> CAAAAATACCCTGACGAAACACCA
ACGTCATTGCGGCCGCAGTTGGGT -> CGTCATTGCGGCCGCAGTTGGGTA
TTGGTGAATAACACATCAAGGCAC -> TGGTGAATAACACATCAAGGCACA
TAATGTCGCTTCATGGTCTGGATT -> AATGTCGCTTCATGGTCTGGATTG
CAAAAATACCCTGACGAAACACCA -> AAAAATACCCTGACGAAACACCAT
CTAAGGTACATTGCTGTGTTGTTT -> TAAGGTACATTGCTGTGTTGTTTG
TTCCGTGTTGTCCTGATAGTACGG -> TCCGTGTTGTCCTGATAGTACGGA
CCTGATAGTACGGAAAGAAGTTGT -> CTGATAGTACGGAAAGAAGTTGTC
TGGCAGTGGGTAGTCTAGGCAGCT -> GGCAGTGGGTAGTCTAGGCAGCTC
TTAGACTACGGGAACTAATCCTGC -> TAGACTACGGGAACTAATCCTGCC
GGTAACTGTTCTACGCTGGGATCA -> GTAACTGTTCTACGCTGGGATCAA
GCATGTTAAGTCTGTCACCTTACC -> CATGTTAAGTCTGTCACCTTACCA
AAATCCACTCAGTATGTATTGGCC -> AATCCACTCAGTATGTATTGGCCC
GGCCGCCCCACGGATCTGGGATGC -> GCCGCCCCACGGATCTGGGATGCT
ACCGGGGATACACCTGAGATGCGC -> CCGGGGATACACCTGAGATGCGCC
TTTGCGGAGTGGATTCCCTACCGG -> TTGCGGAGTGGATTCCCTACCGGG
CGACCAGTCAAGACTCTAATAGTG -> GACCAGTCAAGACTCTAATAGTGT
GATCATGGCAGTGGGTAGTCTAGG -> ATCATGGCAGTGGGTAGTCTAGGC
GATGCGCCCGAACGCCTAATCATC -> ATGCGCCCGAACGCCTAATCATCG
TCCACCTGTAAGAAAAGTTCAGAG -> CCACCTGTAAGAAAAGTTCAGAGG
TGTTGAGGGGTATGGGCTTTTCTA -> GTTGAGGGGTATGGGCTTTTCTAC
ACTAATCCTGCCTTCAGCCCCTGC -> CTAATCCTGCCTTCAGCCCCTGCG
CTATTTGGTAAGTTGTCCCCGACG -> TATTTGGTAAGTTGTCCCCGACGG
ACGTAGCCTCTCAAGATACTTATG -> CGTAGCCTCTCAAGATACTTATGT
CGACCAGCATTGGGTAACTGTTCT -> GACCAGCATTGGGTAACTGTTCTA
ATTGAGCAACTACCCCATTATTGG -> TTGAGCAACTACCCCATTATTGGG
ATCAGTCCGTACGCCCGACCGAAG -> TCAGTCCGTACGCCCGACCGAAGC
TACCACAGACTATTGAGCAACTAC -> ACCACAGACTATTGAGCAACTACC
TCAGGTGCCCTCATCGGCAGATTG -> CAGGTGCCCTCATCGGCAGATTGC
ATGAGCTGCAGGGATGCACTTCAG -> TGAGCTGCAGGGATGCACTTCAGT
TTCACGTTGTAAATCCACTCAGTA -> TCACGTTGTAAATCCACTCAGTAT
GCAGGCGTCATACCGGGGATACAC -> CAGGCGTCATACCGGGGATACACC
GCGAGTAAAGATGGCCGTTACCAA -> CGAGTAAAGATGGCCGTTACCAAA
CACATGTGAAGCCTAGCATACGTT -> ACATGTGAAGCCTAGCATACGTTT
CCTGTAAGAAAAGTTCAGAGGCGG -> CTGTAAGAAAAGTTCAGAGGCGGC
CAGTCCGTACGCCCGACCGAAGCG -> AGTCCGTACGCCCGACCGAAGCGA
GACTGAGGCCTCCATTCCCTAAGG -> ACTGAGGCCTCCATTCCCTAAGGT
AGAAGTGCAGGCGAGTAAAGATGG -> GAAGTGCAGGCGAGTAAAGATGGC
GAGCGTGTTACTCACATCGTGGAG -> AGCGTGTTACTCACATCGTGGAGT
TACTCCTGTGTGTTGCTATGGCCC -> ACTCCTGTGTGTTGCTATGGCCCG
TTCTTTTGCGGAGTGGATTCCCTA -> TCTTTTGCGGAGTGGATTCCCTAC
TGGAGGAAGCGCGCCCTCAATCAG -> GGAGGAAGCGCGCCCTCAATCAGC
GGCTAGGGGCATACCACAGACTAT -> GCTAGGGGCATACCACAGACTATT
AAGGTGCGGCAGATGGGAGTGTTA -> AGGTGCGGCAGATGGGAGTGTTAG
CGCTTCTAACACCCGTGTTCTCTT -> GCTTCTAACACCCGTGTTCTCTTC
AGTTGGGTATGCTTTCCTGTGCGA -> GTTGGGTATGCTTTCCTGTGCGAA
ACCACGTCATTGCGGCCGCAGTTG -> CCACGTCATTGCGGCCGCAGTTGG
CATGGATCAAGTATCTCTGTGACC -> ATGGATCAAGTATCTCTGTGACCA
ATGGCCCGCTTGCTGACGAACGAA -> TGGCCCGCTTGCTGACGAACGAAT
TTATTGGGATGGCCGCCCCACGGA -> TATTGGGATGGCCGCCCCACGGAT
TGCCCTCATCGGCAGATTGCAAGT -> GCCCTCATCGGCAGATTGCAAGTC
GGGATCAACACGGATATACGCGAT -> GGATCAACACGGATATACGCGATC
CTGCCGAAACATCCATGTTGAAAA -> TGCCGAAACATCCATGTTGAAAAA
TAATCATCGGCTATTTGGTAAGTT -> AATCATCGGCTATTTGGTAAGTTG
CGATAAGGTGCGGCAGATGGGAGT -> GATAAGGTGCGGCAGATGGGAGTG
GCCTAATCATCGGCTATTTGGTAA -> CCTAATCATCGGCTATTTGGTAAG
CCGGCGGTCCGAGCTAATGTCGCT -> CGGCGGTCCGAGCTAATGTCGCTT
TTGCGGAGTGGATTCCCTACCGGG -> TGCGGAGTGGATTCCCTACCGGGA
GACTTTGACCGCACTCCTATCACA -> ACTTTGACCGCACTCCTATCACAA
TACAGTAGTTTCTTTTGCGGAGTG -> ACAGTAGTTTCTTTTGCGGAGTGG
ATGAGCGTGTTACTCACATCGTGG -> TGAGCGTGTTACTCACATCGTGGA
AAACATCCATGTTGAAAAAAATGA -> AACATCCATGTTGAAAAAAATGAG
TAGTCAATTGTATCCCGCAAAAAT -> AGTCAATTGTATCCCGCAAAAATA
TCATCAGTCCGTACGCCCGACCGA -> CATCAGTCCGTACGCCCGACCGAA
ACATCGTGGAGTGGACTCTTAAAA -> CATCGTGGAGTGGACTCTTAAAAC
CTACCCCATTATTGGGATGGCCGC -> TACCCCATTATTGGGATGGCCGCC
TCCATGTTGAAAAAAATGAGCGTG -> CCATGTTGAAAAAAATGAGCGTGT
TATGGGCTTTTCTACGGCTCACAC -> ATGGGCTTTTCTACGGCTCACACA
AAGCAGGAATATGCTGAAATGAAA -> AGCAGGAATATGCTGAAATGAAAA
GTAGTCTAGGCAGCTCGGAGTGTC -> TAGTCTAGGCAGCTCGGAGTGTCT
GCTGACGAACGAATGAAGTGGCAA -> CTGACGAACGAATGAAGTGGCAAA
GGTGCGGCAGATGGGAGTGTTAGC -> GTGCGGCAGATGGGAGTGTTAGCA
CAGTATGTATTGGCCCCAAGCAGT -> AGTATGTATTGGCCCCAAGCAGTG
CGCCTAATCATCGGCTATTTGGTA -> GCCTAATCATCGGCTATTTGGTAA
GAGCCCAGTTATCCTTTCCTACAA -> AGCCCAGTTATCCTTTCCTACAAT
GGAGGCTAGGGGCATACCACAGAC -> GAGGCTAGGGGCATACCACAGACT
TCTTAGACTACGGGAACTAATCCT -> CTTAGACTACGGGAACTAATCCTG
GCCACATACTGAAACCCGGGCAGG -> CCACATACTGAAACCCGGGCAGGC
TCACACAGAGCGAAGTTCCAATTC -> CACACAGAGCGAAGTTCCAATTCC
TCCGTACGCCCGACCGAAGCGATT -> CCGTACGCCCGACCGAAGCGATTC
GAATAACACATCAAGGCACACGCT -> AATAACACATCAAGGCACACGCTT
GCCCATGGGTCACGTCGGGCCACC -> CCCATGGGTCACGTCGGGCCACCG
TGTATCCCGCAAAAATACCCTGAC -> GTATCCCGCAAAAATACCCTGACG
AGCATTGGGTAACTGTTCTACGCT -> GCATTGGGTAACTGTTCTACGCTG
CCATTCCCTAAGGTACATTGCTGT -> CATTCCCTAAGGTACATTGCTGTG
GTCACGTCGGGCCACCGGGCATGT -> TCACGTCGGGCCACCGGGCATGTT
TTTTGCGGAGTGGATTCCCTACCG -> TTTGCGGAGTGGATTCCCTACCGG
TATTTGGTAAGTTGTCCCCGACGG -> ATTTGGTAAGTTGTCCCCGACGGA
GTTAGCAAGCGCCCATGGGTCACG -> TTAGCAAGCGCCCATGGGTCACGT
CAAGAAGACATACATTCTTTGCAC -> AAGAAGACATACATTCTTTGCACA
CTCAAGATACTTATGTCTTACATG -> TCAAGATACTTATGTCTTACATGG
CTGTTCTACGCTGGGATCAACACG -> TGTTCTACGCTGGGATCAACACGG
GACGTAACCCAGACCGCCCAGTAG -> ACGTAACCCAGACCGCCCAGTAGC
AATCTGTGCATAACACTCTCCCGG -> ATCTGTGCATAACACTCTCCCGGA
ATTACCTCTGTCAGACACACCGAT -> TTACCTCTGTCAGACACACCGATC
CACCTCATTCCGTGTTGTCCTGAT -> ACCTCATTCCGTGTTGTCCTGATA
TGTATTGGCCCCAAGCAGTGCCAG -> GTATTGGCCCCAAGCAGTGCCAGA
AGAAAAAAATCTGTGCATAACACT -> GAAAAAAATCTGTGCATAACACTC
CGACGGAGCCCAGTTATCCTTTCC -> GACGGAGCCCAGTTATCCTTTCCT
CTCTGTCAGACACACCGATCCCCT -> TCTGTCAGACACACCGATCCCCTG
CACACAGAGCGAAGTTCCAATTCC -> ACACAGAGCGAAGTTCCAATTCCA
TATATCCCCCCTCATGAGTCACCA -> ATATCCCCCCTCATGAGTCACCAT
TCGCCGTTTTAAGACGTAACCCAG -> CGCCGTTTTAAGACGTAACCCAGA
ACTCAGTATGTATTGGCCCCAAGC -> CTCAGTATGTATTGGCCCCAAGCA
CTAATAGTGTAAGAAGTGCAGGCG -> TAATAGTGTAAGAAGTGCAGGCGA
CCCGGACATTAGGCCCCCCGGCTA -> CCGGACATTAGGCCCCCCGGCTAC
TCAATCAGCATTCCGACTACACAG -> CAATCAGCATTCCGACTACACAGC
ACGGCCTCAGGTGCCCTCATCGGC -> CGGCCTCAGGTGCCCTCATCGGCA
GTCATTGCGGCCGCAGTTGGGTAT -> TCATTGCGGCCGCAGTTGGGTATG
GAAGTGGCAAATCACTTGCATCAC -> AAGTGGCAAATCACTTGCATCACG
AACAAAGCAGGAATATGCTGAAAT -> ACAAAGCAGGAATATGCTGAAATG
GTAACCCAGACCGCCCAGTAGCAC -> TAACCCAGACCGCCCAGTAGCACT
AGACTCTAATAGTGTAAGAAGTGC -> GACTCTAATAGTGTAAGAAGTGCA
TGACGTCTTAGACTACGGGAACTA -> GACGTCTTAGACTACGGGAACTAA
CGATGAGCTGCAGGGATGCACTTC -> GATGAGCTGCAGGGATGCACTTCA
AGGCCCCTTTTCATTTAGCTTTTC -> GGCCCCTTTTCATTTAGCTTTTCT
GGCCCCTTTTCATTTAGCTTTTCT -> GCCCCTTTTCATTTAGCTTTTCTT
GGTCTGGATTGGTGAATAACACAT -> GTCTGGATTGGTGAATAACACATC
TACGACCGGCGGTCCGAGCTAATG -> ACGACCGGCGGTCCGAGCTAATGT
GATTCACGTTGTAAATCCACTCAG -> ATTCACGTTGTAAATCCACTCAGT
CGGCTCACACAGAGCGAAGTTCCA -> GGCTCACACAGAGCGAAGTTCCAA
TCAGTATGTATTGGCCCCAAGCAG -> CAGTATGTATTGGCCCCAAGCAGT
TTTGACCGCACTCCTATCACAACG -> TTGACCGCACTCCTATCACAACGG
GTGTCTGTTGCTGCAGCCGGACGG -> TGTCTGTTGCTGCAGCCGGACGGC
TTTGCACATGTGAAGCCTAGCATA -> TTGCACATGTGAAGCCTAGCATAC
AGGAAGCGCGCCCTCAATCAGCAT -> GGAAGCGCGCCCTCAATCAGCATT
AGTGCCAGACTTGACGTCTTAGAC -> GTGCCAGACTTGACGTCTTAGACT
GGCCCGCTTGCTGACGAACGAATG -> GCCCGCTTGCTGACGAACGAATGA
CATTATTGGGATGGCCGCCCCACG -> ATTATTGGGATGGCCGCCCCACGG
TTGTCCTGATAGTACGGAAAGAAG -> TGTCCTGATAGTACGGAAAGAAGT
TTGTCCCCGACGGACATACACAAT -> TGTCCCCGACGGACATACACAATG
CACCTGTAAGAAAAGTTCAGAGGC -> ACCTGTAAGAAAAGTTCAGAGGCG
GCGCGCCCTCAATCAGCATTCCGA -> CGCGCCCTCAATCAGCATTCCGAC
GTGAAGCCTAGCATACGTTTCATC -> TGAAGCCTAGCATACGTTTCATCT
CAGTAACTGGAGGAAGCGCGCCCT -> AGTAACTGGAGGAAGCGCGCCCTC
GCAAACTCGGGCGTTCCGGCCGCC -> CAAACTCGGGCGTTCCGGCCGCCC
TTGCATCACGGTAACTGCTTACCT -> TGCATCACGGTAACTGCTTACCTG
CTTTCTCGCCGTTTTAAGACGTAA -> TTTCTCGCCGTTTTAAGACGTAAC
GACCGGGACTTTGACCGCACTCCT -> ACCGGGACTTTGACCGCACTCCTA
TAACGGCCTCAGGTGCCCTCATCG -> AACGGCCTCAGGTGCCCTCATCGG
CTTACATGGATCAAGTATCTCTGT -> TTACATGGATCAAGTATCTCTGTG
TCTTAAAACCTGACTTGAGTGTAG -> CTTAAAACCTGACTTGAGTGTAGG
AGTGTAAGAAGTGCAGGCGAGTAA -> GTGTAAGAAGTGCAGGCGAGTAAA
GCCCTACTAACGGCCTCAGGTGCC -> CCCTACTAACGGCCTCAGGTGCCC
AACCAAACGATGAGCTGCAGGGAT -> ACCAAACGATGAGCTGCAGGGATG
TGCAGCCGGACGGCGTCCTCCATA -> GCAGCCGGACGGCGTCCTCCATAG
GCGGCAGATGGGAGTGTTAGCAAG -> CGGCAGATGGGAGTGTTAGCAAGC
ACGACCGGCGGTCCGAGCTAATGT -> CGACCGGCGGTCCGAGCTAATGTC
ATTACCGTCTTTGCTCACGAATCT -> TTACCGTCTTTGCTCACGAATCTT
TCTCAAGATACTTATGTCTTACAT -> CTCAAGATACTTATGTCTTACATG
CGTTTATGCAGCGACCAGCATTGG -> GTTTATGCAGCGACCAGCATTGGG
GGATTGGTGAATAACACATCAAGG -> GATTGGTGAATAACACATCAAGGC
CAGTGCCAGACTTGACGTCTTAGA -> AGTGCCAGACTTGACGTCTTAGAC
TTAAGTCTGTCACCTTACCAAGCA -> TAAGTCTGTCACCTTACCAAGCAG
AATGCGACGGAGCCCAGTTATCCT -> ATGCGACGGAGCCCAGTTATCCTT
GGGTTAGATAATGTCCATGGTCTC -> GGTTAGATAATGTCCATGGTCTCA
ATCCAGACATGTGCACTCGGACCG -> TCCAGACATGTGCACTCGGACCGA
TCCATTCCCTAAGGTACATTGCTG -> CCATTCCCTAAGGTACATTGCTGT
GCACACGCTTCGGGGACTGGCTAA -> CACACGCTTCGGGGACTGGCTAAG
CGCTTGCTGACGAACGAATGAAGT -> GCTTGCTGACGAACGAATGAAGTG
GGACTGTATATCCCCCCTCATGAG -> GACTGTATATCCCCCCTCATGAGT
GGACGTCTCATGCAATCTGCCGTA -> GACGTCTCATGCAATCTGCCGTAA
GAGATGCGCCCGAACGCCTAATCA -> AGATGCGCCCGAACGCCTAATCAT
CGAACGAATGAAGTGGCAAATCAC -> GAACGAATGAAGTGGCAAATCACT
ATCCCGCAAAAATACCCTGACGAA -> TCCCGCAAAAATACCCTGACGAAA
AGTTTCTTTTGCGGAGTGGATTCC -> GTTTCTTTTGCGGAGTGGATTCCC
ACATTGCTGTGTTGTTTGGTCGTG -> CATTGCTGTGTTGTTTGGTCGTGG
GCACCAACTGTGGGTTTAAAGTCG -> CACCAACTGTGGGTTTAAAGTCGC
ATACTTATGTCTTACATGGATCAA -> TACTTATGTCTTACATGGATCAAG
TGTTAGCAAGCGCCCATGGGTCAC -> GTTAGCAAGCGCCCATGGGTCACG
TTTGGTAAGTTGTCCCCGACGGAC -> TTGGTAAGTTGTCCCCGACGGACA
ACAGAAAAAAATCTGTGCATAACA -> CAGAAAAAAATCTGTGCATAACAC
TGGTCTCACATCTGAGTTAGCAAC -> GGTCTCACATCTGAGTTAGCAACG
ATTCCTATTACCTCTGTCAGACAC -> TTCCTATTACCTCTGTCAGACACA
TACCCTGACGAAACACCATTTAGG -> ACCCTGACGAAACACCATTTAGGA
CCGGGACTTTGACCGCACTCCTAT -> CGGGACTTTGACCGCACTCCTATC
ACTTGCCCGGCCCTCCTTGGCAAA -> CTTGCCCGGCCCTCCTTGGCAAAC
TCTGTCAGACACACCGATCCCCTG -> CTGTCAGACACACCGATCCCCTGT
AGTTCCAATTCCAACTGCAGTAAC -> GTTCCAATTCCAACTGCAGTAACT
CCCATGGGTCACGTCGGGCCACCG -> CCATGGGTCACGTCGGGCCACCGG
GTTGGCACGCTTCTAACACCCGTG -> TTGGCACGCTTCTAACACCCGTGT
GTCTTACATGGATCAAGTATCTCT -> TCTTACATGGATCAAGTATCTCTG
GACGAACGAATGAAGTGGCAAATC -> ACGAACGAATGAAGTGGCAAATCA
GTAGCACTCAATGTCGGGTATGAC -> TAGCACTCAATGTCGGGTATGACC
TGTCATGAACGCGGCAAGGGGTTA -> GTCATGAACGCGGCAAGGGGTTAG
AGCCTCTCAAGATACTTATGTCTT -> GCCTCTCAAGATACTTATGTCTTA
TAGACTACGGGAACTAATCCTGCC -> AGACTACGGGAACTAATCCTGCCT
CAGCCGGACGGCGTCCTCCATAGG -> AGCCGGACGGCGTCCTCCATAGGA
GCTATGGCCCGCTTGCTGACGAAC -> CTATGGCCCGCTTGCTGACGAACG
AACTAATCCTGCCTTCAGCCCCTG -> ACTAATCCTGCCTTCAGCCCCTGC
AGCGAAGTTCCAATTCCAACTGCA -> GCGAAGTTCCAATTCCAACTGCAG
GACACACCGATCCCCTGTTAGGCC -> ACACACCGATCCCCTGTTAGGCCC
CCGGCTACAGTGGGATTCACGTTG -> CGGCTACAGTGGGATTCACGTTGT
GGCTAAGGTCCGATAAGGTGCGGC -> GCTAAGGTCCGATAAGGTGCGGCA
GGTTAGATAATGTCCATGGTCTCA -> GTTAGATAATGTCCATGGTCTCAC
TAGTGTAAGAAGTGCAGGCGAGTA -> AGTGTAAGAAGTGCAGGCGAGTAA
CATTCCGACTACACAGCTATGATC -> ATTCCGACTACACAGCTATGATCA
CTACACAGCTATGATCATGGCAGT -> TACACAGCTATGATCATGGCAGTG
GCTTAGAATGCATTCAGTATACAT -> CTTAGAATGCATTCAGTATACATC
CCGATAAGGTGCGGCAGATGGGAG -> CGATAAGGTGCGGCAGATGGGAGT
TTCGGGGACTGGCTAAGGTCCGAT -> TCGGGGACTGGCTAAGGTCCGATA
CGTCTTTGCTCACGAATCTTCACC -> GTCTTTGCTCACGAATCTTCACCT
GCCCCTGCGGCTTATAGTGGCAAG -> CCCCTGCGGCTTATAGTGGCAAGG
CGGGCCACCGGGCATGTTAAGTCT -> GGGCCACCGGGCATGTTAAGTCTG
TGGTACTGCGCCGTCGGACTGAGG -> GGTACTGCGCCGTCGGACTGAGGC
GTTTTGGTATCCAGACATGTGCAC -> TTTTGGTATCCAGACATGTGCACT
CTAACGGCCTCAGGTGCCCTCATC -> TAACGGCCTCAGGTGCCCTCATCG
GAGTGTAGGCCTGTCACTTTGATC -> AGTGTAGGCCTGTCACTTTGATCA
GATGGCCGCCCCACGGATCTGGGA -> ATGGCCGCCCCACGGATCTGGGAT
TTTGTCATGAACGCGGCAAGGGGT -> TTGTCATGAACGCGGCAAGGGGTT
CATTCCGTGTTGTCCTGATAGTAC -> ATTCCGTGTTGTCCTGATAGTACG
TAATGTCCATGGTCTCACATCTGA -> AATGTCCATGGTCTCACATCTGAG
GTAAGTTGTCCCCGACGGACATAC -> TAAGTTGTCCCCGACGGACATACA
CACATACTGAAACCCGGGCAGGCG -> ACATACTGAAACCCGGGCAGGCGT
TTCCGACTACACAGCTATGATCAT -> TCCGACTACACAGCTATGATCATG
CCTCATCGGCAGATTGCAAGTCAT -> CTCATCGGCAGATTGCAAGTCATA
ACCTGTAAGAAAAGTTCAGAGGCG -> CCTGTAAGAAAAGTTCAGAGGCGG
ACTCCTATCACAACGGCATAGTCA -> CTCCTATCACAACGGCATAGTCAA
CCTGCGGCTTATAGTGGCAAGGCT -> CTGCGGCTTATAGTGGCAAGGCTA
CTTTGCTACTAGCTTCTCTCTTCA -> TTTGCTACTAGCTTCTCTCTTCAT
TCAGAGTAAGATGGGCACCAACTG -> CAGAGTAAGATGGGCACCAACTGT
CTACTAACGGCCTCAGGTGCCCTC -> TACTAACGGCCTCAGGTGCCCTCA
TACTAACGGCCTCAGGTGCCCTCA -> ACTAACGGCCTCAGGTGCCCTCAT
TCTCTTCCAGGAAACTATGCCAGA -> CTCTTCCAGGAAACTATGCCAGAC
ACGTTTATGCAGCGACCAGCATTG -> CGTTTATGCAGCGACCAGCATTGG
GTTGTCCTGATAGTACGGAAAGAA -> TTGTCCTGATAGTACGGAAAGAAG
TACCGTCTTTGCTCACGAATCTTC -> ACCGTCTTTGCTCACGAATCTTCA
AGTGTTAGCAAGCGCCCATGGGTC -> GTGTTAGCAAGCGCCCATGGGTCA
AATTCAGACCGCCAACCAAACGAT -> ATTCAGACCGCCAACCAAACGATG
TGTTAGGCCCCTTTTCATTTAGCT -> GTTAGGCCCCTTTTCATTTAGCTT
CACGTTGTAAATCCACTCAGTATG -> ACGTTGTAAATCCACTCAGTATGT
CGAAACACCATTTAGGACTTTGCT -> GAAACACCATTTAGGACTTTGCTA
CCGGCCGCCCGCGAAGCCCTACTA -> CGGCCGCCCGCGAAGCCCTACTAA
AGTTAGGAGGCTAGGGGCATACCA -> GTTAGGAGGCTAGGGGCATACCAC
AGCGACCAGCATTGGGTAACTGTT -> GCGACCAGCATTGGGTAACTGTTC
GGAGTGGACTCTTAAAACCTGACT -> GAGTGGACTCTTAAAACCTGACTT
TGCAGGGATGCACTTCAGTGGGCC -> GCAGGGATGCACTTCAGTGGGCCC
CTCATTCCGTGTTGTCCTGATAGT -> TCATTCCGTGTTGTCCTGATAGTA
ACTCTAATAGTGTAAGAAGTGCAG -> CTCTAATAGTGTAAGAAGTGCAGG
CGGGGACTGGCTAAGGTCCGATAA -> GGGGACTGGCTAAGGTCCGATAAG
GACCACGTCATTGCGGCCGCAGTT -> ACCACGTCATTGCGGCCGCAGTTG
TGCGAAGATTCCTTAATTCAGACC -> GCGAAGATTCCTTAATTCAGACCG
CGTACGCCCGACCGAAGCGATTCC -> GTACGCCCGACCGAAGCGATTCCT
GAGTGTTAGCAAGCGCCCATGGGT -> AGTGTTAGCAAGCGCCCATGGGTC
CCGGGACCGGGACTTTGACCGCAC -> CGGGACCGGGACTTTGACCGCACT
TCTGTTGAGGGGTATGGGCTTTTC -> CTGTTGAGGGGTATGGGCTTTTCT
CTGAGATGCGCCCGAACGCCTAAT -> TGAGATGCGCCCGAACGCCTAATC
AACTGGAGGAAGCGCGCCCTCAAT -> ACTGGAGGAAGCGCGCCCTCAATC
CAGTATACATCTTACTCCTGTGTG -> AGTATACATCTTACTCCTGTGTGT
TACGGGAACTAATCCTGCCTTCAG -> ACGGGAACTAATCCTGCCTTCAGC
CTGCCGTAACAAATCTTTTTAAGC -> TGCCGTAACAAATCTTTTTAAGCC
TCTTTTTAAGCCAGAACATGAACA -> CTTTTTAAGCCAGAACATGAACAA
CTCCATTCCCTAAGGTACATTGCT -> TCCATTCCCTAAGGTACATTGCTG
AGGCCTGTCACTTTGATCAGAGTA -> GGCCTGTCACTTTGATCAGAGTAA
TGTTGTTTGGTCGTGGCCACCGAC -> GTTGTTTGGTCGTGGCCACCGACC
CAGACGGACGTCTCATGCAATCTG -> AGACGGACGTCTCATGCAATCTGC
CGGGACTTTGACCGCACTCCTATC -> GGGACTTTGACCGCACTCCTATCA
GAGCTGCAGGGATGCACTTCAGTG -> AGCTGCAGGGATGCACTTCAGTGG
TTACTCACATCGTGGAGTGGACTC -> TACTCACATCGTGGAGTGGACTCT
CAACCAAACGATGAGCTGCAGGGA -> AACCAAACGATGAGCTGCAGGGAT
TGATCATGGCAGTGGGTAGTCTAG -> GATCATGGCAGTGGGTAGTCTAGG
ACAAAGCAGGAATATGCTGAAATG -> CAAAGCAGGAATATGCTGAAATGA
GTTGTTTGGTCGTGGCCACCGACC -> TTGTTTGGTCGTGGCCACCGACCA
TCCTGCCGAAACATCCATGTTGAA -> CCTGCCGAAACATCCATGTTGAAA
GCTAAGGTCCGATAAGGTGCGGCA -> CTAAGGTCCGATAAGGTGCGGCAG
ACTTCAGTGGGCCCTGTTGTAGGA -> CTTCAGTGGGCCCTGTTGTAGGAC
AGAGGCGGCGGTATACGTTTATGC -> GAGGCGGCGGTATACGTTTATGCA
ACTCGGACCGAGCGACCTCCACCT -> CTCGGACCGAGCGACCTCCACCTG
TGCATTCAGTATACATCTTACTCC -> GCATTCAGTATACATCTTACTCCT
CGAAGCGATTCCTATTACCTCTGT -> GAAGCGATTCCTATTACCTCTGTC
TGCTCACGAATCTTCACCTCATTC -> GCTCACGAATCTTCACCTCATTCC
CGACGGACATACACAATGTGTTTT -> GACGGACATACACAATGTGTTTTG
GTCTTACGACCGGCGGTCCGAGCT -> TCTTACGACCGGCGGTCCGAGCTA
TATCCTTTCCTACAATCCTGAGCG -> ATCCTTTCCTACAATCCTGAGCGG
CCTGTCACTTTGATCAGAGTAAGA -> CTGTCACTTTGATCAGAGTAAGAT
GGGGCATACCACAGACTATTGAGC -> GGGCATACCACAGACTATTGAGCA
AAGAAAAGTTCAGAGGCGGCGGTA -> AGAAAAGTTCAGAGGCGGCGGTAT
AGTTGTCCCCGACGGACATACACA -> GTTGTCCCCGACGGACATACACAA
AAATGAAAAGCTGGTCTGTCTTAC -> AATGAAAAGCTGGTCTGTCTTACG
GCTGGGATCAACACGGATATACGC -> CTGGGATCAACACGGATATACGCG
ATACATTCTTTGCACATGTGAAGC -> TACATTCTTTGCACATGTGAAGCC
CTCGGAGTAGCTAGTACCTGGTAC -> TCGGAGTAGCTAGTACCTGGTACT
TTGGTATCCAGACATGTGCACTCG -> TGGTATCCAGACATGTGCACTCGG
GGCTATTTGGTAAGTTGTCCCCGA -> GCTATTTGGTAAGTTGTCCCCGAC
TGCATAATTACCGTCTTTGCTCAC -> GCATAATTACCGTCTTTGCTCACG
TACACAGCTATGATCATGGCAGTG -> ACACAGCTATGATCATGGCAGTGG
TGACCGCACTCCTATCACAACGGC -> GACCGCACTCCTATCACAACGGCA
ACATCAAGGCACACGCTTCGGGGA -> CATCAAGGCACACGCTTCGGGGAC
TCCTGAGCGGGGGTACTCATAAGT -> CCTGAGCGGGGGTACTCATAAGTT
TGTTCTCGGAGTAGCTAGTACCTG -> GTTCTCGGAGTAGCTAGTACCTGG
ACCACAGACTATTGAGCAACTACC -> CCACAGACTATTGAGCAACTACCC
GTCCGAGCTAATGTCGCTTCATGG -> TCCGAGCTAATGTCGCTTCATGGT
TAAGTCTGTCACCTTACCAAGCAG -> AAGTCTGTCACCTTACCAAGCAGT
ATGGGCTTTTCTACGGCTCACACA -> TGGGCTTTTCTACGGCTCACACAG
GGGCATACCACAGACTATTGAGCA -> GGCATACCACAGACTATTGAGCAA
GCCGCAGTTGGGTATGCTTTCCTG -> CCGCAGTTGGGTATGCTTTCCTGT
GTACATTGCTGTGTTGTTTGGTCG -> TACATTGCTGTGTTGTTTGGTCGT
TATGGCCCGCTTGCTGACGAACGA -> ATGGCCCGCTTGCTGACGAACGAA
CCTGTTAGGCCCCTTTTCATTTAG -> CTGTTAGGCCCCTTTTCATTTAGC
GTTTCTTTTGCGGAGTGGATTCCC -> TTTCTTTTGCGGAGTGGATTCCCT
GTGGGTAGTCTAGGCAGCTCGGAG -> TGGGTAGTCTAGGCAGCTCGGAGT
TGGCCCCAAGCAGTGCCAGACTTG -> GGCCCCAAGCAGTGCCAGACTTGA
TTGGTAAGTTGTCCCCGACGGACA -> TGGTAAGTTGTCCCCGACGGACAT
ATCAGCATTCCGACTACACAGCTA -> TCAGCATTCCGACTACACAGCTAT
ATACCACAGACTATTGAGCAACTA -> TACCACAGACTATTGAGCAACTAC
GTATGCTTTCCTGTGCGAAGATTC -> TATGCTTTCCTGTGCGAAGATTCC
CCAAGCAGTGCCAGACTTGACGTC -> CAAGCAGTGCCAGACTTGACGTCT
GCAGTGCCAGACTTGACGTCTTAG -> CAGTGCCAGACTTGACGTCTTAGA
ATAGAGCCACATACTGAAACCCGG -> TAGAGCCACATACTGAAACCCGGG
GCGAAGTTCCAATTCCAACTGCAG -> CGAAGTTCCAATTCCAACTGCAGT
CATACACAATGTGTTTTGGTATCC -> ATACACAATGTGTTTTGGTATCCA
TGGGTAACTGTTCTACGCTGGGAT -> GGGTAACTGTTCTACGCTGGGATC
AAAAATGAGCGTGTTACTCACATC -> AAAATGAGCGTGTTACTCACATCG
CGGAGTAGCTAGTACCTGGTACTG -> GGAGTAGCTAGTACCTGGTACTGC
TTTCTCGCCGTTTTAAGACGTAAC -> TTCTCGCCGTTTTAAGACGTAACC
TGAAAAAAATGAGCGTGTTACTCA -> GAAAAAAATGAGCGTGTTACTCAC
TACAGTGGGATTCACGTTGTAAAT -> ACAGTGGGATTCACGTTGTAAATC
ATGCTGAAATGAAAAGCTGGTCTG -> TGCTGAAATGAAAAGCTGGTCTGT
GTATGACCCAAGAAGACATACATT -> TATGACCCAAGAAGACATACATTC
CTATGCCAGACGGACGTCTCATGC -> TATGCCAGACGGACGTCTCATGCA
GTTGAAAAAAATGAGCGTGTTACT -> TTGAAAAAAATGAGCGTGTTACTC
TATACATCTTACTCCTGTGTGTTG -> ATACATCTTACTCCTGTGTGTTGC
TTCCCTAAGGTACATTGCTGTGTT -> TCCCTAAGGTACATTGCTGTGTTG
GGCGGTCCGAGCTAATGTCGCTTC -> GCGGTCCGAGCTAATGTCGCTTCA
CGAGCCTCTGTTGAGGGGTATGGG -> GAGCCTCTGTTGAGGGGTATGGGC
CAATCTGCCGTAACAAATCTTTTT -> AATCTGCCGTAACAAATCTTTTTA
GATTCCCTACCGGGACCGGGACTT -> ATTCCCTACCGGGACCGGGACTTT
GCAAGCGCCCATGGGTCACGTCGG -> CAAGCGCCCATGGGTCACGTCGGG
TGTGTTGCTATGGCCCGCTTGCTG -> GTGTTGCTATGGCCCGCTTGCTGA
AGTTGGCACGCTTCTAACACCCGT -> GTTGGCACGCTTCTAACACCCGTG
GTGGCAAGGCTACAGTAGTTTCTT -> TGGCAAGGCTACAGTAGTTTCTTT
CTTATGTCTTACATGGATCAAGTA -> TTATGTCTTACATGGATCAAGTAT
TGCTGTGTTGTTTGGTCGTGGCCA -> GCTGTGTTGTTTGGTCGTGGCCAC
AGGGATGCACTTCAGTGGGCCCTG -> GGGATGCACTTCAGTGGGCCCTGT
CTATTACCTCTGTCAGACACACCG -> TATTACCTCTGTCAGACACACCGA
ACTGTTCTACGCTGGGATCAACAC -> CTGTTCTACGCTGGGATCAACACG
TCCTGTGCGAAGATTCCTTAATTC -> CCTGTGCGAAGATTCCTTAATTCA
TGCTTTCTCGCCGTTTTAAGACGT -> GCTTTCTCGCCGTTTTAAGACGTA
ATGCTTTCTCGCCGTTTTAAGACG -> TGCTTTCTCGCCGTTTTAAGACGT
GTTTGGTCGTGGCCACCGACCAGT -> TTTGGTCGTGGCCACCGACCAGTC
GGTAAGTTGTCCCCGACGGACATA -> GTAAGTTGTCCCCGACGGACATAC
GTGGATTCCCTACCGGGACCGGGA -> TGGATTCCCTACCGGGACCGGGAC
CTCAATCAGCATTCCGACTACACA -> TCAATCAGCATTCCGACTACACAG
AGTGGGATTCACGTTGTAAATCCA -> GTGGGATTCACGTTGTAAATCCAC
CGACTACACAGCTATGATCATGGC -> GACTACACAGCTATGATCATGGCA
GAACATGAACAAAGCAGGAATATG -> AACATGAACAAAGCAGGAATATGC
TGTAAGAAGTGCAGGCGAGTAAAG -> GTAAGAAGTGCAGGCGAGTAAAGA
CCTATCACAACGGCATAGTCAATT -> CTATCACAACGGCATAGTCAATTG
GGGCTTTTCTACGGCTCACACAGA -> GGCTTTTCTACGGCTCACACAGAG
AAGAAGACATACATTCTTTGCACA -> AGAAGACATACATTCTTTGCACAT
TTTTTAAGCCAGAACATGAACAAA -> TTTTAAGCCAGAACATGAACAAAG
AACGATGAGCTGCAGGGATGCACT -> ACGATGAGCTGCAGGGATGCACTT
TGGCAAACTCGGGCGTTCCGGCCG -> GGCAAACTCGGGCGTTCCGGCCGC
CCAGTTATCCTTTCCTACAATCCT -> CAGTTATCCTTTCCTACAATCCTG
GTACTCATAAGTTGGCACGCTTCT -> TACTCATAAGTTGGCACGCTTCTA
AAAACCTGACTTGAGTGTAGGCCT -> AAACCTGACTTGAGTGTAGGCCTG
CCAACCAAACGATGAGCTGCAGGG -> CAACCAAACGATGAGCTGCAGGGA
TTAGGCCCCCCGGCTACAGTGGGA -> TAGGCCCCCCGGCTACAGTGGGAT
AGTCGCCGCTTAGAATGCATTCAG -> GTCGCCGCTTAGAATGCATTCAGT
TCGGCAGATTGCAAGTCATAGAGC -> CGGCAGATTGCAAGTCATAGAGCC
GAATATGCTGAAATGAAAAGCTGG -> AATATGCTGAAATGAAAAGCTGGT
GTTCTACGCTGGGATCAACACGGA -> TTCTACGCTGGGATCAACACGGAT
GAGCAACTACCCCATTATTGGGAT -> AGCAACTACCCCATTATTGGGATG
TAAAACCTGACTTGAGTGTAGGCC -> AAAACCTGACTTGAGTGTAGGCCT
TGGGTCACGTCGGGCCACCGGGCA -> GGGTCACGTCGGGCCACCGGGCAT
TGTCTTACATGGATCAAGTATCTC -> GTCTTACATGGATCAAGTATCTCT
ACCGTCTTTGCTCACGAATCTTCA -> CCGTCTTTGCTCACGAATCTTCAC
GTATTGGCCCCAAGCAGTGCCAGA -> TATTGGCCCCAAGCAGTGCCAGAC
TGTCGCTTCATGGTCTGGATTGGT -> GTCGCTTCATGGTCTGGATTGGTG
ATGCTTTCCTGTGCGAAGATTCCT -> TGCTTTCCTGTGCGAAGATTCCTT
CACTCAATGTCGGGTATGACCCAA -> ACTCAATGTCGGGTATGACCCAAG
ATGCAGCGACCAGCATTGGGTAAC -> TGCAGCGACCAGCATTGGGTAACT
ACTCTTAAAACCTGACTTGAGTGT -> CTCTTAAAACCTGACTTGAGTGTA
TTCTACGCTGGGATCAACACGGAT -> TCTACGCTGGGATCAACACGGATA
ATCCTTTCCTACAATCCTGAGCGG -> TCCTTTCCTACAATCCTGAGCGGG
CCGAGCTAATGTCGCTTCATGGTC -> CGAGCTAATGTCGCTTCATGGTCT
TGTGGGTTTAAAGTCGCCGCTTAG -> GTGGGTTTAAAGTCGCCGCTTAGA
ATTGCGGCCGCAGTTGGGTATGCT -> TTGCGGCCGCAGTTGGGTATGCTT
GGCTTATAGTGGCAAGGCTACAGT -> GCTTATAGTGGCAAGGCTACAGTA
ATCGGCAGATTGCAAGTCATAGAG -> TCGGCAGATTGCAAGTCATAGAGC
ACCGGGACTTTGACCGCACTCCTA -> CCGGGACTTTGACCGCACTCCTAT
ACTTGAGTGTAGGCCTGTCACTTT -> CTTGAGTGTAGGCCTGTCACTTTG
TGCCAGACGGACGTCTCATGCAAT -> GCCAGACGGACGTCTCATGCAATC
CTGCAGTAACTGGAGGAAGCGCGC -> TGCAGTAACTGGAGGAAGCGCGCC
GTAACTGTTCTACGCTGGGATCAA -> TAACTGTTCTACGCTGGGATCAAC
GCTTTCTCGCCGTTTTAAGACGTA -> CTTTCTCGCCGTTTTAAGACGTAA
TATACGCGATCCTGCCGAAACATC -> ATACGCGATCCTGCCGAAACATCC
ATTCCGACTACACAGCTATGATCA -> TTCCGACTACACAGCTATGATCAT
GCCCTCATCGGCAGATTGCAAGTC -> CCCTCATCGGCAGATTGCAAGTCA
CCCTACCGGGACCGGGACTTTGAC -> CCTACCGGGACCGGGACTTTGACC
TCATAAGTTGGCACGCTTCTAACA -> CATAAGTTGGCACGCTTCTAACAC
TCTTTTGCGGAGTGGATTCCCTAC -> CTTTTGCGGAGTGGATTCCCTACC
TCCAGACATGTGCACTCGGACCGA -> CCAGACATGTGCACTCGGACCGAG
GCACTCAATGTCGGGTATGACCCA -> CACTCAATGTCGGGTATGACCCAA
CAAGATACTTATGTCTTACATGGA -> AAGATACTTATGTCTTACATGGAT
CCGACCAGTCAAGACTCTAATAGT -> CGACCAGTCAAGACTCTAATAGTG
ACGAAACACCATTTAGGACTTTGC -> CGAAACACCATTTAGGACTTTGCT
CGAGTAAAGATGGCCGTTACCAAA -> GAGTAAAGATGGCCGTTACCAAAC
GTGGGATTCACGTTGTAAATCCAC -> TGGGATTCACGTTGTAAATCCACT
ATAGTGGCAAGGCTACAGTAGTTT -> TAGTGGCAAGGCTACAGTAGTTTC
TAGTACCTGGTACTGCGCCGTCGG -> AGTACCTGGTACTGCGCCGTCGGA
ACGGCTCACACAGAGCGAAGTTCC -> CGGCTCACACAGAGCGAAGTTCCA
CGGTATACGTTTATGCAGCGACCA -> GGTATACGTTTATGCAGCGACCAG
TCTTCACCTCATTCCGTGTTGTCC -> CTTCACCTCATTCCGTGTTGTCCT
GTACGGAAAGAAGTTGTCGAGCCT -> TACGGAAAGAAGTTGTCGAGCCTC
AAATCTTTTTAAGCCAGAACATGA -> AATCTTTTTAAGCCAGAACATGAA
TTAGCAAGCGCCCATGGGTCACGT -> TAGCAAGCGCCCATGGGTCACGTC
CTGTGCATAACACTCTCCCGGACA -> TGTGCATAACACTCTCCCGGACAT
AAAAAATCTGTGCATAACACTCTC -> AAAAATCTGTGCATAACACTCTCC
GACTACACAGCTATGATCATGGCA -> ACTACACAGCTATGATCATGGCAG
TCCCGCAAAAATACCCTGACGAAA -> CCCGCAAAAATACCCTGACGAAAC
TTGCGGCCGCAGTTGGGTATGCTT -> TGCGGCCGCAGTTGGGTATGCTTT
TAGTACGGAAAGAAGTTGTCGAGC -> AGTACGGAAAGAAGTTGTCGAGCC
GGCAGATTGCAAGTCATAGAGCCA -> GCAGATTGCAAGTCATAGAGCCAC
CTGCGCCGTCGGACTGAGGCCTCC -> TGCGCCGTCGGACTGAGGCCTCCA
GCAAGGCTACAGTAGTTTCTTTTG -> CAAGGCTACAGTAGTTTCTTTTGC
ACATGAACAAAGCAGGAATATGCT -> CATGAACAAAGCAGGAATATGCTG
GCAAATCACTTGCATCACGGTAAC -> CAAATCACTTGCATCACGGTAACT
TTTATGCAGCGACCAGCATTGGGT -> TTATGCAGCGACCAGCATTGGGTA
TATGACCCAAGAAGACATACATTC -> ATGACCCAAGAAGACATACATTCT
GATAATGTCCATGGTCTCACATCT -> ATAATGTCCATGGTCTCACATCTG
TTTAGCTTTTCTTTTTGTCATGAA -> TTAGCTTTTCTTTTTGTCATGAAC
TGACGAAACACCATTTAGGACTTT -> GACGAAACACCATTTAGGACTTTG
ATAGTGTAAGAAGTGCAGGCGAGT -> TAGTGTAAGAAGTGCAGGCGAGTA
ATGGTCTCACATCTGAGTTAGCAA -> TGGTCTCACATCTGAGTTAGCAAC
GGCACACGCTTCGGGGACTGGCTA -> GCACACGCTTCGGGGACTGGCTAA
TGGCAAGGCTACAGTAGTTTCTTT -> GGCAAGGCTACAGTAGTTTCTTTT
AATGAAAAGCTGGTCTGTCTTACG -> ATGAAAAGCTGGTCTGTCTTACGA
TGTATATCCCCCCTCATGAGTCAC -> GTATATCCCCCCTCATGAGTCACC
AAACCCGGGCAGGCGTCATACCGG -> AACCCGGGCAGGCGTCATACCGGG
CAAACGATGAGCTGCAGGGATGCA -> AAACGATGAGCTGCAGGGATGCAC
ATTATTGGGATGGCCGCCCCACGG -> TTATTGGGATGGCCGCCCCACGGA
AGTAAAGATGGCCGTTACCAAACT -> GTAAAGATGGCCGTTACCAAACTT
TCTTTGCACATGTGAAGCCTAGCA -> CTTTGCACATGTGAAGCCTAGCAT
TCAGTGGGCCCTGTTGTAGGACTG -> CAGTGGGCCCTGTTGTAGGACTGT
TGCAGTAACTGGAGGAAGCGCGCC -> GCAGTAACTGGAGGAAGCGCGCCC
CCTCCACCTGTAAGAAAAGTTCAG -> CTCCACCTGTAAGAAAAGTTCAGA
TATACGTTTATGCAGCGACCAGCA -> ATACGTTTATGCAGCGACCAGCAT
CACCCGTGTTCTCTTCCAGGAAAC -> ACCCGTGTTCTCTTCCAGGAAACT
GGCTCACACAGAGCGAAGTTCCAA -> GCTCACACAGAGCGAAGTTCCAAT
ACGTTTCATCTACAGAAAAAAATC -> CGTTTCATCTACAGAAAAAAATCT
GCATACCACAGACTATTGAGCAAC -> CATACCACAGACTATTGAGCAACT
CATGGTCTCACATCTGAGTTAGCA -> ATGGTCTCACATCTGAGTTAGCAA
AAGATGGGCACCAACTGTGGGTTT -> AGATGGGCACCAACTGTGGGTTTA
ACTCGGGCGTTCCGGCCGCCCGCG -> CTCGGGCGTTCCGGCCGCCCGCGA
CCGGGCAGGCGTCATACCGGGGAT -> CGGGCAGGCGTCATACCGGGGATA
AATCCTGAGCGGGGGTACTCATAA -> ATCCTGAGCGGGGGTACTCATAAG
TGTAGGACTGTATATCCCCCCTCA -> GTAGGACTGTATATCCCCCCTCAT
TAGCACTCAATGTCGGGTATGACC -> AGCACTCAATGTCGGGTATGACCC
TGGGATCAACACGGATATACGCGA -> GGGATCAACACGGATATACGCGAT
TCTCTTCATCAGTCCGTACGCCCG -> CTCTTCATCAGTCCGTACGCCCGA
CGGATATACGCGATCCTGCCGAAA -> GGATATACGCGATCCTGCCGAAAC
ACTGGAGGAAGCGCGCCCTCAATC -> CTGGAGGAAGCGCGCCCTCAATCA
ACCGCCCAGTAGCACTCAATGTCG -> CCGCCCAGTAGCACTCAATGTCGG
GCACGCTTCTAACACCCGTGTTCT -> CACGCTTCTAACACCCGTGTTCTC
CGCTGGGATCAACACGGATATACG -> GCTGGGATCAACACGGATATACGC
TGAATAACACATCAAGGCACACGC -> GAATAACACATCAAGGCACACGCT
GTAAAGATGGCCGTTACCAAACTT -> TAAAGATGGCCGTTACCAAACTTG
ACCTGCATAATTACCGTCTTTGCT -> CCTGCATAATTACCGTCTTTGCTC
GCCCTCAATCAGCATTCCGACTAC -> CCCTCAATCAGCATTCCGACTACA
AATGAAGTGGCAAATCACTTGCAT -> ATGAAGTGGCAAATCACTTGCATC
TAAGTTGTCCCCGACGGACATACA -> AAGTTGTCCCCGACGGACATACAC
AAAATACCCTGACGAAACACCATT -> AAATACCCTGACGAAACACCATTT
TCCGATAAGGTGCGGCAGATGGGA -> CCGATAAGGTGCGGCAGATGGGAG
GAAATGAAAAGCTGGTCTGTCTTA -> AAATGAAAAGCTGGTCTGTCTTAC
ATACATCTTACTCCTGTGTGTTGC -> TACATCTTACTCCTGTGTGTTGCT
TTCCCTACCGGGACCGGGACTTTG -> TCCCTACCGGGACCGGGACTTTGA
ATTGTATCCCGCAAAAATACCCTG -> TTGTATCCCGCAAAAATACCCTGA
CGGGAACTAATCCTGCCTTCAGCC -> GGGAACTAATCCTGCCTTCAGCCC
TCAATGTCGGGTATGACCCAAGAA -> CAATGTCGGGTATGACCCAAGAAG
TAACACCCGTGTTCTCTTCCAGGA -> AACACCCGTGTTCTCTTCCAGGAA
AATCAGCATTCCGACTACACAGCT -> ATCAGCATTCCGACTACACAGCTA
TCTGCCGTAACAAATCTTTTTAAG -> CTGCCGTAACAAATCTTTTTAAGC
CTTTGATCAGAGTAAGATGGGCAC -> TTTGATCAGAGTAAGATGGGCACC
GCGCCCTCAATCAGCATTCCGACT -> CGCCCTCAATCAGCATTCCGACTA
CGGAGCCCAGTTATCCTTTCCTAC -> GGAGCCCAGTTATCCTTTCCTACA
TTTCTTTTTGTCATGAACGCGGCA -> TTCTTTTTGTCATGAACGCGGCAA
TTTCCTGTGCGAAGATTCCTTAAT -> TTCCTGTGCGAAGATTCCTTAATT
CGTTTTAAGACGTAACCCAGACCG -> GTTTTAAGACGTAACCCAGACCGC
ACCGGGCATGTTAAGTCTGTCACC -> CCGGGCATGTTAAGTCTGTCACCT
TCCAGGAAACTATGCCAGACGGAC -> CCAGGAAACTATGCCAGACGGACG
TGTTCTCTTCCAGGAAACTATGCC -> GTTCTCTTCCAGGAAACTATGCCA
ATGGATCAAGTATCTCTGTGACCA -> TGGATCAAGTATCTCTGTGACCAC
GGTACTGCGCCGTCGGACTGAGGC -> GTACTGCGCCGTCGGACTGAGGCC
TTTTGTCATGAACGCGGCAAGGGG -> TTTGTCATGAACGCGGCAAGGGGT
AGAACATGAACAAAGCAGGAATAT -> GAACATGAACAAAGCAGGAATATG
AAGTTGTCGAGCCTCTGTTGAGGG -> AGTTGTCGAGCCTCTGTTGAGGGG
AACTACCCCATTATTGGGATGGCC -> ACTACCCCATTATTGGGATGGCCG
ACTCATAAGTTGGCACGCTTCTAA -> CTCATAAGTTGGCACGCTTCTAAC
CATAGAGCCACATACTGAAACCCG -> ATAGAGCCACATACTGAAACCCGG
GGGTACTCATAAGTTGGCACGCTT -> GGTACTCATAAGTTGGCACGCTTC
TACATGGATCAAGTATCTCTGTGA -> ACATGGATCAAGTATCTCTGTGAC
TTGCTATGGCCCGCTTGCTGACGA -> TGCTATGGCCCGCTTGCTGACGAA
GGGTAGTCTAGGCAGCTCGGAGTG -> GGTAGTCTAGGCAGCTCGGAGTGT
TGGGCACCAACTGTGGGTTTAAAG -> GGGCACCAACTGTGGGTTTAAAGT
CGGGTATGACCCAAGAAGACATAC -> GGGTATGACCCAAGAAGACATACA
ATTAGGCCCCCCGGCTACAGTGGG -> TTAGGCCCCCCGGCTACAGTGGGA
CCCGACCGAAGCGATTCCTATTAC -> CCGACCGAAGCGATTCCTATTACC
GCATTCAGTATACATCTTACTCCT -> CATTCAGTATACATCTTACTCCTG
TCCCCTGTTAGGCCCCTTTTCATT -> CCCCTGTTAGGCCCCTTTTCATTT
CTGTTGCTGCAGCCGGACGGCGTC -> TGTTGCTGCAGCCGGACGGCGTCC
AAAGATGGCCGTTACCAAACTTGC -> AAGATGGCCGTTACCAAACTTGCC
ACGGGAACTAATCCTGCCTTCAGC -> CGGGAACTAATCCTGCCTTCAGCC
AACGAATGAAGTGGCAAATCACTT -> ACGAATGAAGTGGCAAATCACTTG
GTCCCCGACGGACATACACAATGT -> TCCCCGACGGACATACACAATGTG
GGAACTAATCCTGCCTTCAGCCCC -> GAACTAATCCTGCCTTCAGCCCCT
AACTGCTTACCTGCATAATTACCG -> ACTGCTTACCTGCATAATTACCGT
TTTGGTATCCAGACATGTGCACTC -> TTGGTATCCAGACATGTGCACTCG
TTGTCGAGCCTCTGTTGAGGGGTA -> TGTCGAGCCTCTGTTGAGGGGTAT
ACCTCTGTCAGACACACCGATCCC -> CCTCTGTCAGACACACCGATCCCC
CATCTGAGTTAGCAACGTAGCCTC -> ATCTGAGTTAGCAACGTAGCCTCT
CCGTGTTGTCCTGATAGTACGGAA -> CGTGTTGTCCTGATAGTACGGAAA
ACCGCACTCCTATCACAACGGCAT -> CCGCACTCCTATCACAACGGCATA
TACACAATGTGTTTTGGTATCCAG -> ACACAATGTGTTTTGGTATCCAGA
GCTTGCTGACGAACGAATGAAGTG -> CTTGCTGACGAACGAATGAAGTGG
TTTAAAGTCGCCGCTTAGAATGCA -> TTAAAGTCGCCGCTTAGAATGCAT
AGCTGGTCTGTCTTACGACCGGCG -> GCTGGTCTGTCTTACGACCGGCGG
TGAAATGAAAAGCTGGTCTGTCTT -> GAAATGAAAAGCTGGTCTGTCTTA
CGGCTTATAGTGGCAAGGCTACAG -> GGCTTATAGTGGCAAGGCTACAGT
AGCATACGTTTCATCTACAGAAAA -> GCATACGTTTCATCTACAGAAAAA
ACTTGACGTCTTAGACTACGGGAA -> CTTGACGTCTTAGACTACGGGAAC
CATTTAGCTTTTCTTTTTGTCATG -> ATTTAGCTTTTCTTTTTGTCATGA
CCACGTCATTGCGGCCGCAGTTGG -> CACGTCATTGCGGCCGCAGTTGGG
CATAATTACCGTCTTTGCTCACGA -> ATAATTACCGTCTTTGCTCACGAA
ATACACAATGTGTTTTGGTATCCA -> TACACAATGTGTTTTGGTATCCAG
ATGACCCAAGAAGACATACATTCT -> TGACCCAAGAAGACATACATTCTT
CGGAAAGAAGTTGTCGAGCCTCTG -> GGAAAGAAGTTGTCGAGCCTCTGT
GGATCAACACGGATATACGCGATC -> GATCAACACGGATATACGCGATCC
CCACTCAGTATGTATTGGCCCCAA -> CACTCAGTATGTATTGGCCCCAAG
TTAGCAACGTAGCCTCTCAAGATA -> TAGCAACGTAGCCTCTCAAGATAC
TCTAGGCAGCTCGGAGTGTCTGTT -> CTAGGCAGCTCGGAGTGTCTGTTG
GACCGCCAACCAAACGATGAGCTG -> ACCGCCAACCAAACGATGAGCTGC
TATCTCTGTGACCACGTCATTGCG -> ATCTCTGTGACCACGTCATTGCGG
AAGCCTAGCATACGTTTCATCTAC -> AGCCTAGCATACGTTTCATCTACA
CGGACATACACAATGTGTTTTGGT -> GGACATACACAATGTGTTTTGGTA
TGGGTATGCTTTCCTGTGCGAAGA -> GGGTATGCTTTCCTGTGCGAAGAT
GTCATACCGGGGATACACCTGAGA -> TCATACCGGGGATACACCTGAGAT
TACCGGGGATACACCTGAGATGCG -> ACCGGGGATACACCTGAGATGCGC
GATTGCAAGTCATAGAGCCACATA -> ATTGCAAGTCATAGAGCCACATAC
TCATACCGGGGATACACCTGAGAT -> CATACCGGGGATACACCTGAGATG
GTCATGAACGCGGCAAGGGGTTAG -> TCATGAACGCGGCAAGGGGTTAGA
GGATTCACGTTGTAAATCCACTCA -> GATTCACGTTGTAAATCCACTCAG
TGGTCTGTCTTACGACCGGCGGTC -> GGTCTGTCTTACGACCGGCGGTCC
AAAAAAATGAGCGTGTTACTCACA -> AAAAAATGAGCGTGTTACTCACAT
ATAGTACGGAAAGAAGTTGTCGAG -> TAGTACGGAAAGAAGTTGTCGAGC
TGTGTTTTGGTATCCAGACATGTG -> GTGTTTTGGTATCCAGACATGTGC
CATGTTAAGTCTGTCACCTTACCA -> ATGTTAAGTCTGTCACCTTACCAA
CTCACATCGTGGAGTGGACTCTTA -> TCACATCGTGGAGTGGACTCTTAA
TTGAAAAAAATGAGCGTGTTACTC -> TGAAAAAAATGAGCGTGTTACTCA
AGGCCTCCATTCCCTAAGGTACAT -> GGCCTCCATTCCCTAAGGTACATT
TTCCTATTACCTCTGTCAGACACA -> TCCTATTACCTCTGTCAGACACAC
CCTAGCATACGTTTCATCTACAGA -> CTAGCATACGTTTCATCTACAGAA
TTTGATCAGAGTAAGATGGGCACC -> TTGATCAGAGTAAGATGGGCACCA
CACACCGATCCCCTGTTAGGCCCC -> ACACCGATCCCCTGTTAGGCCCCT
AATCCACTCAGTATGTATTGGCCC -> ATCCACTCAGTATGTATTGGCCCC
AGTCTGTCACCTTACCAAGCAGTT -> GTCTGTCACCTTACCAAGCAGTTA
CACACGCTTCGGGGACTGGCTAAG -> ACACGCTTCGGGGACTGGCTAAGG
ACAGTGGGATTCACGTTGTAAATC -> CAGTGGGATTCACGTTGTAAATCC
GGCAAACTCGGGCGTTCCGGCCGC -> GCAAACTCGGGCGTTCCGGCCGCC
CCTGACTTGAGTGTAGGCCTGTCA -> CTGACTTGAGTGTAGGCCTGTCAC
CTCCTGTGTGTTGCTATGGCCCGC -> TCCTGTGTGTTGCTATGGCCCGCT
CGCCGCTTAGAATGCATTCAGTAT -> GCCGCTTAGAATGCATTCAGTATA
TGAGGCCTCCATTCCCTAAGGTAC -> GAGGCCTCCATTCCCTAAGGTACA
CCTCCTTGGCAAACTCGGGCGTTC -> CTCCTTGGCAAACTCGGGCGTTCC
CCCTGTTGTAGGACTGTATATCCC -> CCTGTTGTAGGACTGTATATCCCC
GGCAGCTCGGAGTGTCTGTTGCTG -> GCAGCTCGGAGTGTCTGTTGCTGC
GCTAGTACCTGGTACTGCGCCGTC -> CTAGTACCTGGTACTGCGCCGTCG
GGTACTCATAAGTTGGCACGCTTC -> GTACTCATAAGTTGGCACGCTTCT
GCCCCTTTTCATTTAGCTTTTCTT -> CCCCTTTTCATTTAGCTTTTCTTT
TGTCACTTTGATCAGAGTAAGATG -> GTCACTTTGATCAGAGTAAGATGG
ACCCAGACCGCCCAGTAGCACTCA -> CCCAGACCGCCCAGTAGCACTCAA
TCCTTTCCTACAATCCTGAGCGGG -> CCTTTCCTACAATCCTGAGCGGGG
CTATTGAGCAACTACCCCATTATT -> TATTGAGCAACTACCCCATTATTG
TCGGACCGAGCGACCTCCACCTGT -> CGGACCGAGCGACCTCCACCTGTA
AGGAGGCTAGGGGCATACCACAGA -> GGAGGCTAGGGGCATACCACAGAC
GTATACATCTTACTCCTGTGTGTT -> TATACATCTTACTCCTGTGTGTTG
AGTAGTTTCTTTTGCGGAGTGGAT -> GTAGTTTCTTTTGCGGAGTGGATT
TCACAACGGCATAGTCAATTGTAT -> CACAACGGCATAGTCAATTGTATC
GGCGTTCCGGCCGCCCGCGAAGCC -> GCGTTCCGGCCGCCCGCGAAGCCC
CAGTGGGTAGTCTAGGCAGCTCGG -> AGTGGGTAGTCTAGGCAGCTCGGA
ATACCGGGGATACACCTGAGATGC -> TACCGGGGATACACCTGAGATGCG
GAGCCACATACTGAAACCCGGGCA -> AGCCACATACTGAAACCCGGGCAG
GTACCTGGTACTGCGCCGTCGGAC -> TACCTGGTACTGCGCCGTCGGACT
AGTTGTCGAGCCTCTGTTGAGGGG -> GTTGTCGAGCCTCTGTTGAGGGGT
ACTATGCCAGACGGACGTCTCATG -> CTATGCCAGACGGACGTCTCATGC
CTGCAGCCGGACGGCGTCCTCCAT -> TGCAGCCGGACGGCGTCCTCCATA
CCAAACTTGCCCGGCCCTCCTTGG -> CAAACTTGCCCGGCCCTCCTTGGC
GTGCGAAGATTCCTTAATTCAGAC -> TGCGAAGATTCCTTAATTCAGACC
TAACAAATCTTTTTAAGCCAGAAC -> AACAAATCTTTTTAAGCCAGAACA
CCGCTTAGAATGCATTCAGTATAC -> CGCTTAGAATGCATTCAGTATACA
AACTGTTCTACGCTGGGATCAACA -> ACTGTTCTACGCTGGGATCAACAC
CGGGGATACACCTGAGATGCGCCC -> GGGGATACACCTGAGATGCGCCCG
GACATTAGGCCCCCCGGCTACAGT -> ACATTAGGCCCCCCGGCTACAGTG
GCTCGGAGTGTCTGTTGCTGCAGC -> CTCGGAGTGTCTGTTGCTGCAGCC
AAGTTCAGAGGCGGCGGTATACGT -> AGTTCAGAGGCGGCGGTATACGTT
TAAGGTCCGATAAGGTGCGGCAGA -> AAGGTCCGATAAGGTGCGGCAGAT
GAGCGAAGTTCCAATTCCAACTGC -> AGCGAAGTTCCAATTCCAACTGCA
AATAACACATCAAGGCACACGCTT -> ATAACACATCAAGGCACACGCTTC
CTGTAAGAAAAGTTCAGAGGCGGC -> TGTAAGAAAAGTTCAGAGGCGGCG
GCTAGGGGCATACCACAGACTATT -> CTAGGGGCATACCACAGACTATTG
CATCGTGGAGTGGACTCTTAAAAC -> ATCGTGGAGTGGACTCTTAAAACC
GGGATGGCCGCCCCACGGATCTGG -> GGATGGCCGCCCCACGGATCTGGG
CCCGCGAAGCCCTACTAACGGCCT -> CCGCGAAGCCCTACTAACGGCCTC
TGAGGGGTATGGGCTTTTCTACGG -> GAGGGGTATGGGCTTTTCTACGGC
GCTGTGTTGTTTGGTCGTGGCCAC -> CTGTGTTGTTTGGTCGTGGCCACC
AGACTATTGAGCAACTACCCCATT -> GACTATTGAGCAACTACCCCATTA
ATTTGGTAAGTTGTCCCCGACGGA -> TTTGGTAAGTTGTCCCCGACGGAC
GAGGCGGCGGTATACGTTTATGCA -> AGGCGGCGGTATACGTTTATGCAG
CGTAACAAATCTTTTTAAGCCAGA -> GTAACAAATCTTTTTAAGCCAGAA
ACGTCTCATGCAATCTGCCGTAAC -> CGTCTCATGCAATCTGCCGTAACA
ACCTTACCAAGCAGTTAGTTAGGA -> CCTTACCAAGCAGTTAGTTAGGAG
ACTCAATGTCGGGTATGACCCAAG -> CTCAATGTCGGGTATGACCCAAGA
CTACAGTGGGATTCACGTTGTAAA -> TACAGTGGGATTCACGTTGTAAAT
TGAGTGTAGGCCTGTCACTTTGAT -> GAGTGTAGGCCTGTCACTTTGATC
CTACGGCTCACACAGAGCGAAGTT -> TACGGCTCACACAGAGCGAAGTTC
GGTATACGTTTATGCAGCGACCAG -> GTATACGTTTATGCAGCGACCAGC
GTTGCTATGGCCCGCTTGCTGACG -> TTGCTATGGCCCGCTTGCTGACGA
TTCTCGCCGTTTTAAGACGTAACC -> TCTCGCCGTTTTAAGACGTAACCC
ACTTTGATCAGAGTAAGATGGGCA -> CTTTGATCAGAGTAAGATGGGCAC
GTGGAGTGGACTCTTAAAACCTGA -> TGGAGTGGACTCTTAAAACCTGAC
GCGCCCATGGGTCACGTCGGGCCA -> CGCCCATGGGTCACGTCGGGCCAC
TACGCCCGACCGAAGCGATTCCTA -> ACGCCCGACCGAAGCGATTCCTAT
TCAGAGGCGGCGGTATACGTTTAT -> CAGAGGCGGCGGTATACGTTTATG
ATCAACACGGATATACGCGATCCT -> TCAACACGGATATACGCGATCCTG
GCCTCTCAAGATACTTATGTCTTA -> CCTCTCAAGATACTTATGTCTTAC
GGGTATGGGCTTTTCTACGGCTCA -> GGTATGGGCTTTTCTACGGCTCAC
GAGCGACCTCCACCTGTAAGAAAA -> AGCGACCTCCACCTGTAAGAAAAG
AAACGATGAGCTGCAGGGATGCAC -> AACGATGAGCTGCAGGGATGCACT
AGCAGGAATATGCTGAAATGAAAA -> GCAGGAATATGCTGAAATGAAAAG
CAATGTGTTTTGGTATCCAGACAT -> AATGTGTTTTGGTATCCAGACATG
CTGACTTGAGTGTAGGCCTGTCAC -> TGACTTGAGTGTAGGCCTGTCACT
GGAGGAAGCGCGCCCTCAATCAGC -> GAGGAAGCGCGCCCTCAATCAGCA
GCTTCGGGGACTGGCTAAGGTCCG -> CTTCGGGGACTGGCTAAGGTCCGA
CACATCAAGGCACACGCTTCGGGG -> ACATCAAGGCACACGCTTCGGGGA
GATCAACACGGATATACGCGATCC -> ATCAACACGGATATACGCGATCCT
CCAGAACATGAACAAAGCAGGAAT -> CAGAACATGAACAAAGCAGGAATA
GAACGCCTAATCATCGGCTATTTG -> AACGCCTAATCATCGGCTATTTGG
GGACTGGCTAAGGTCCGATAAGGT -> GACTGGCTAAGGTCCGATAAGGTG
GTGTTCTCGGAGTAGCTAGTACCT -> TGTTCTCGGAGTAGCTAGTACCTG
TCCGGCCGCCCGCGAAGCCCTACT -> CCGGCCGCCCGCGAAGCCCTACTA
CTCATCGGCAGATTGCAAGTCATA -> TCATCGGCAGATTGCAAGTCATAG
TAAGATGGGCACCAACTGTGGGTT -> AAGATGGGCACCAACTGTGGGTTT
ATGTCCATGGTCTCACATCTGAGT -> TGTCCATGGTCTCACATCTGAGTT
CTGTTGTAGGACTGTATATCCCCC -> TGTTGTAGGACTGTATATCCCCCC
GCAGATTGCAAGTCATAGAGCCAC -> CAGATTGCAAGTCATAGAGCCACA
CCAGCATTGGGTAACTGTTCTACG -> CAGCATTGGGTAACTGTTCTACGC
GCCCTCCTTGGCAAACTCGGGCGT -> CCCTCCTTGGCAAACTCGGGCGTT
TGAGCGTGTTACTCACATCGTGGA -> GAGCGTGTTACTCACATCGTGGAG
GGCATAGTCAATTGTATCCCGCAA -> GCATAGTCAATTGTATCCCGCAAA
GAGGCCTCCATTCCCTAAGGTACA -> AGGCCTCCATTCCCTAAGGTACAT
TGAGATGCGCCCGAACGCCTAATC -> GAGATGCGCCCGAACGCCTAATCA
CTGTGTGTTGCTATGGCCCGCTTG -> TGTGTGTTGCTATGGCCCGCTTGC
GAACTAATCCTGCCTTCAGCCCCT -> AACTAATCCTGCCTTCAGCCCCTG
AGCTTCTCTCTTCATCAGTCCGTA -> GCTTCTCTCTTCATCAGTCCGTAC
GCCACCGACCAGTCAAGACTCTAA -> CCACCGACCAGTCAAGACTCTAAT
ATAATGTCCATGGTCTCACATCTG -> TAATGTCCATGGTCTCACATCTGA
GGTCACGTCGGGCCACCGGGCATG -> GTCACGTCGGGCCACCGGGCATGT
GATGGCCGTTACCAAACTTGCCCG -> ATGGCCGTTACCAAACTTGCCCGG
CGCCGTTTTAAGACGTAACCCAGA -> GCCGTTTTAAGACGTAACCCAGAC
TCAAGGCACACGCTTCGGGGACTG -> CAAGGCACACGCTTCGGGGACTGG
TAAGGTACATTGCTGTGTTGTTTG -> AAGGTACATTGCTGTGTTGTTTGG
AAAAGTTCAGAGGCGGCGGTATAC -> AAAGTTCAGAGGCGGCGGTATACG
TGGTGAATAACACATCAAGGCACA -> GGTGAATAACACATCAAGGCACAC
GGATGGCCGCCCCACGGATCTGGG -> GATGGCCGCCCCACGGATCTGGGA
AAGACATACATTCTTTGCACATGT -> AGACATACATTCTTTGCACATGTG
CTCATGCAATCTGCCGTAACAAAT -> TCATGCAATCTGCCGTAACAAATC
CCTGCCTTCAGCCCCTGCGGCTTA -> CTGCCTTCAGCCCCTGCGGCTTAT
CAGACTTGACGTCTTAGACTACGG -> AGACTTGACGTCTTAGACTACGGG
AAAAAATGAGCGTGTTACTCACAT -> AAAAATGAGCGTGTTACTCACATC
CTAGCTTCTCTCTTCATCAGTCCG -> TAGCTTCTCTCTTCATCAGTCCGT
AGACCGCCCAGTAGCACTCAATGT -> GACCGCCCAGTAGCACTCAATGTC
GTTCTCGGAGTAGCTAGTACCTGG -> TTCTCGGAGTAGCTAGTACCTGGT
CATCAGTCCGTACGCCCGACCGAA -> ATCAGTCCGTACGCCCGACCGAAG
GAGTAAGATGGGCACCAACTGTGG -> AGTAAGATGGGCACCAACTGTGGG
GTTGTCGAGCCTCTGTTGAGGGGT -> TTGTCGAGCCTCTGTTGAGGGGTA
AGTAGCTAGTACCTGGTACTGCGC -> GTAGCTAGTACCTGGTACTGCGCC
ACTAACGGCCTCAGGTGCCCTCAT -> CTAACGGCCTCAGGTGCCCTCATC
GTGGGTTTAAAGTCGCCGCTTAGA -> TGGGTTTAAAGTCGCCGCTTAGAA
GTCACCTTACCAAGCAGTTAGTTA -> TCACCTTACCAAGCAGTTAGTTAG
ACGAATCTTCACCTCATTCCGTGT -> CGAATCTTCACCTCATTCCGTGTT
GCGATTCCTATTACCTCTGTCAGA -> CGATTCCTATTACCTCTGTCAGAC
CAATTGTATCCCGCAAAAATACCC -> AATTGTATCCCGCAAAAATACCCT
TTACATGGATCAAGTATCTCTGTG -> TACATGGATCAAGTATCTCTGTGA
ACGTTGTAAATCCACTCAGTATGT -> CGTTGTAAATCCACTCAGTATGTA
ACCCAAGAAGACATACATTCTTTG -> CCCAAGAAGACATACATTCTTTGC
CCCAGTTATCCTTTCCTACAATCC -> CCAGTTATCCTTTCCTACAATCCT
CAAATCACTTGCATCACGGTAACT -> AAATCACTTGCATCACGGTAACTG
GAAACATCCATGTTGAAAAAAATG -> AAACATCCATGTTGAAAAAAATGA
CCTATTACCTCTGTCAGACACACC -> CTATTACCTCTGTCAGACACACCG
TGCAAGTCATAGAGCCACATACTG -> GCAAGTCATAGAGCCACATACTGA
GACCTCCACCTGTAAGAAAAGTTC -> ACCTCCACCTGTAAGAAAAGTTCA
ACATGTGCACTCGGACCGAGCGAC -> CATGTGCACTCGGACCGAGCGACC
CATGGGTCACGTCGGGCCACCGGG -> ATGGGTCACGTCGGGCCACCGGGC
ACACGCTTCGGGGACTGGCTAAGG -> CACGCTTCGGGGACTGGCTAAGGT
TTGGCCCCAAGCAGTGCCAGACTT -> TGGCCCCAAGCAGTGCCAGACTTG
TTGGGTAACTGTTCTACGCTGGGA -> TGGGTAACTGTTCTACGCTGGGAT
CAAGGCACACGCTTCGGGGACTGG -> AAGGCACACGCTTCGGGGACTGGC
ACTGCAGTAACTGGAGGAAGCGCG -> CTGCAGTAACTGGAGGAAGCGCGC
CTTACCTGCATAATTACCGTCTTT -> TTACCTGCATAATTACCGTCTTTG
CCATGGTCTCACATCTGAGTTAGC -> CATGGTCTCACATCTGAGTTAGCA
CGGACTGAGGCCTCCATTCCCTAA -> GGACTGAGGCCTCCATTCCCTAAG
GTTTTAAGACGTAACCCAGACCGC -> TTTTAAGACGTAACCCAGACCGCC
TCATGGTCTGGATTGGTGAATAAC -> CATGGTCTGGATTGGTGAATAACA
CACTCCTATCACAACGGCATAGTC -> ACTCCTATCACAACGGCATAGTCA
GTAGGCCTGTCACTTTGATCAGAG -> TAGGCCTGTCACTTTGATCAGAGT
GGGACCGGGACTTTGACCGCACTC -> GGACCGGGACTTTGACCGCACTCC
CGAAGCCCTACTAACGGCCTCAGG -> GAAGCCCTACTAACGGCCTCAGGT
AACATGAACAAAGCAGGAATATGC -> ACATGAACAAAGCAGGAATATGCT
AGATGGGCACCAACTGTGGGTTTA -> GATGGGCACCAACTGTGGGTTTAA
ACACCCGTGTTCTCTTCCAGGAAA -> CACCCGTGTTCTCTTCCAGGAAAC
TTAGTTAGGAGGCTAGGGGCATAC -> TAGTTAGGAGGCTAGGGGCATACC
ACTACCCCATTATTGGGATGGCCG -> CTACCCCATTATTGGGATGGCCGC
CACCGATCCCCTGTTAGGCCCCTT -> ACCGATCCCCTGTTAGGCCCCTTT
TCTGTCTTACGACCGGCGGTCCGA -> CTGTCTTACGACCGGCGGTCCGAG
CCCCCGGCTACAGTGGGATTCACG -> CCCCGGCTACAGTGGGATTCACGT
TCTCCCGGACATTAGGCCCCCCGG -> CTCCCGGACATTAGGCCCCCCGGC
GCGACGGAGCCCAGTTATCCTTTC -> CGACGGAGCCCAGTTATCCTTTCC
TTTGCTCACGAATCTTCACCTCAT -> TTGCTCACGAATCTTCACCTCATT
AAGGGGTTAGATAATGTCCATGGT -> AGGGGTTAGATAATGTCCATGGTC
ACGGATCTGGGATGCTTTCTCGCC -> CGGATCTGGGATGCTTTCTCGCCG
TAGGAATGCGACGGAGCCCAGTTA -> AGGAATGCGACGGAGCCCAGTTAT
GGCAGATGGGAGTGTTAGCAAGCG -> GCAGATGGGAGTGTTAGCAAGCGC
CCCGCTTGCTGACGAACGAATGAA -> CCGCTTGCTGACGAACGAATGAAG
GGATCTGGGATGCTTTCTCGCCGT -> GATCTGGGATGCTTTCTCGCCGTT
GTTGAGGGGTATGGGCTTTTCTAC -> TTGAGGGGTATGGGCTTTTCTACG
GTCTTAGACTACGGGAACTAATCC -> TCTTAGACTACGGGAACTAATCCT
CCCCATTATTGGGATGGCCGCCCC -> CCCATTATTGGGATGGCCGCCCCA
GACCGAAGCGATTCCTATTACCTC -> ACCGAAGCGATTCCTATTACCTCT
TAGGCCTGTCACTTTGATCAGAGT -> AGGCCTGTCACTTTGATCAGAGTA
ATAGTCAATTGTATCCCGCAAAAA -> TAGTCAATTGTATCCCGCAAAAAT
CTAATGTCGCTTCATGGTCTGGAT -> TAATGTCGCTTCATGGTCTGGATT
GGTCGTGGCCACCGACCAGTCAAG -> GTCGTGGCCACCGACCAGTCAAGA
GACATACATTCTTTGCACATGTGA -> ACATACATTCTTTGCACATGTGAA
CATGGTCTGGATTGGTGAATAACA -> ATGGTCTGGATTGGTGAATAACAC
GCATAACACTCTCCCGGACATTAG -> CATAACACTCTCCCGGACATTAGG
CCTCAGGTGCCCTCATCGGCAGAT -> CTCAGGTGCCCTCATCGGCAGATT
AAAGCAGGAATATGCTGAAATGAA -> AAGCAGGAATATGCTGAAATGAAA
GGGTATGACCCAAGAAGACATACA -> GGTATGACCCAAGAAGACATACAT
AAGGCTACAGTAGTTTCTTTTGCG -> AGGCTACAGTAGTTTCTTTTGCGG
CCGTCTTTGCTCACGAATCTTCAC -> CGTCTTTGCTCACGAATCTTCACC
GTGCAGGCGAGTAAAGATGGCCGT -> TGCAGGCGAGTAAAGATGGCCGTT
CTCCCGGACATTAGGCCCCCCGGC -> TCCCGGACATTAGGCCCCCCGGCT
TTGTATCCCGCAAAAATACCCTGA -> TGTATCCCGCAAAAATACCCTGAC
ATTGCAAGTCATAGAGCCACATAC -> TTGCAAGTCATAGAGCCACATACT
ATCACAACGGCATAGTCAATTGTA -> TCACAACGGCATAGTCAATTGTAT
TTAGGCCCCTTTTCATTTAGCTTT -> TAGGCCCCTTTTCATTTAGCTTTT
TCATTCCGTGTTGTCCTGATAGTA -> CATTCCGTGTTGTCCTGATAGTAC
ATTTAGGACTTTGCTACTAGCTTC -> TTTAGGACTTTGCTACTAGCTTCT
AGAGTAAGATGGGCACCAACTGTG -> GAGTAAGATGGGCACCAACTGTGG
TCCCTAAGGTACATTGCTGTGTTG -> CCCTAAGGTACATTGCTGTGTTGT
CTTTCCTGTGCGAAGATTCCTTAA -> TTTCCTGTGCGAAGATTCCTTAAT
CAGGCGTCATACCGGGGATACACC -> AGGCGTCATACCGGGGATACACCT
GGAGTGGATTCCCTACCGGGACCG -> GAGTGGATTCCCTACCGGGACCGG
ATGAACGCGGCAAGGGGTTAGATA -> TGAACGCGGCAAGGGGTTAGATAA
CAGAACATGAACAAAGCAGGAATA -> AGAACATGAACAAAGCAGGAATAT
CACTTGCATCACGGTAACTGCTTA -> ACTTGCATCACGGTAACTGCTTAC
GGCCGTTACCAAACTTGCCCGGCC -> GCCGTTACCAAACTTGCCCGGCCC
CCCCTTTTCATTTAGCTTTTCTTT -> CCCTTTTCATTTAGCTTTTCTTTT
AATGCATTCAGTATACATCTTACT -> ATGCATTCAGTATACATCTTACTC
GCAGTGGGTAGTCTAGGCAGCTCG -> CAGTGGGTAGTCTAGGCAGCTCGG
AAGATGGCCGTTACCAAACTTGCC -> AGATGGCCGTTACCAAACTTGCCC
TGGTCGTGGCCACCGACCAGTCAA -> GGTCGTGGCCACCGACCAGTCAAG
GCCGGACGGCGTCCTCCATAGGAA -> CCGGACGGCGTCCTCCATAGGAAT
CACAGAGCGAAGTTCCAATTCCAA -> ACAGAGCGAAGTTCCAATTCCAAC
GGCTACAGTAGTTTCTTTTGCGGA -> GCTACAGTAGTTTCTTTTGCGGAG
TACTCATAAGTTGGCACGCTTCTA -> ACTCATAAGTTGGCACGCTTCTAA
CAAGACTCTAATAGTGTAAGAAGT -> AAGACTCTAATAGTGTAAGAAGTG
GGCACCAACTGTGGGTTTAAAGTC -> GCACCAACTGTGGGTTTAAAGTCG
CCGCAAAAATACCCTGACGAAACA -> CGCAAAAATACCCTGACGAAACAC
CGTAGCCTCTCAAGATACTTATGT -> GTAGCCTCTCAAGATACTTATGTC
GCACTCGGACCGAGCGACCTCCAC -> CACTCGGACCGAGCGACCTCCACC
CTGAAATGAAAAGCTGGTCTGTCT -> TGAAATGAAAAGCTGGTCTGTCTT
TTACCGTCTTTGCTCACGAATCTT -> TACCGTCTTTGCTCACGAATCTTC
CTACAATCCTGAGCGGGGGTACTC -> TACAATCCTGAGCGGGGGTACTCA
ACATACTGAAACCCGGGCAGGCGT -> CATACTGAAACCCGGGCAGGCGTC
CCCGAACGCCTAATCATCGGCTAT -> CCGAACGCCTAATCATCGGCTATT
AAGAAGTTGTCGAGCCTCTGTTGA -> AGAAGTTGTCGAGCCTCTGTTGAG
AGGCACACGCTTCGGGGACTGGCT -> GGCACACGCTTCGGGGACTGGCTA
GCGATCCTGCCGAAACATCCATGT -> CGATCCTGCCGAAACATCCATGTT
TCATTGCGGCCGCAGTTGGGTATG -> CATTGCGGCCGCAGTTGGGTATGC
CTCATAAGTTGGCACGCTTCTAAC -> TCATAAGTTGGCACGCTTCTAACA
GGCATGTTAAGTCTGTCACCTTAC -> GCATGTTAAGTCTGTCACCTTACC
GGGATACACCTGAGATGCGCCCGA -> GGATACACCTGAGATGCGCCCGAA
TTCTTTTTGTCATGAACGCGGCAA -> TCTTTTTGTCATGAACGCGGCAAG
GTTACCAAACTTGCCCGGCCCTCC -> TTACCAAACTTGCCCGGCCCTCCT
GAAGCCCTACTAACGGCCTCAGGT -> AAGCCCTACTAACGGCCTCAGGTG
GTGTTGTTTGGTCGTGGCCACCGA -> TGTTGTTTGGTCGTGGCCACCGAC
CCGCCCAGTAGCACTCAATGTCGG -> CGCCCAGTAGCACTCAATGTCGGG
CGTCGGACTGAGGCCTCCATTCCC -> GTCGGACTGAGGCCTCCATTCCCT
TGTTTTGGTATCCAGACATGTGCA -> GTTTTGGTATCCAGACATGTGCAC
GCTGAAATGAAAAGCTGGTCTGTC -> CTGAAATGAAAAGCTGGTCTGTCT
TAAGACGTAACCCAGACCGCCCAG -> AAGACGTAACCCAGACCGCCCAGT
CTGAGTTAGCAACGTAGCCTCTCA -> TGAGTTAGCAACGTAGCCTCTCAA
TGGGATGCTTTCTCGCCGTTTTAA -> GGGATGCTTTCTCGCCGTTTTAAG
ACTTGCATCACGGTAACTGCTTAC -> CTTGCATCACGGTAACTGCTTACC
GCCTCTGTTGAGGGGTATGGGCTT -> CCTCTGTTGAGGGGTATGGGCTTT
TTCAGACCGCCAACCAAACGATGA -> TCAGACCGCCAACCAAACGATGAG
CTGGTACTGCGCCGTCGGACTGAG -> TGGTACTGCGCCGTCGGACTGAGG
CTAACACCCGTGTTCTCTTCCAGG -> TAACACCCGTGTTCTCTTCCAGGA
TGCAATCTGCCGTAACAAATCTTT -> GCAATCTGCCGTAACAAATCTTTT
CAAAGCAGGAATATGCTGAAATGA -> AAAGCAGGAATATGCTGAAATGAA
ACCATTTAGGACTTTGCTACTAGC -> CCATTTAGGACTTTGCTACTAGCT
ATCTTACTCCTGTGTGTTGCTATG -> TCTTACTCCTGTGTGTTGCTATGG
TAGGCCCCTTTTCATTTAGCTTTT -> AGGCCCCTTTTCATTTAGCTTTTC
TCATAGAGCCACATACTGAAACCC -> CATAGAGCCACATACTGAAACCCG
TACGGCTCACACAGAGCGAAGTTC -> ACGGCTCACACAGAGCGAAGTTCC
TGGCCCGCTTGCTGACGAACGAAT -> GGCCCGCTTGCTGACGAACGAATG
TTCATCTACAGAAAAAAATCTGTG -> TCATCTACAGAAAAAAATCTGTGC
AATGTGTTTTGGTATCCAGACATG -> ATGTGTTTTGGTATCCAGACATGT
GACTATTGAGCAACTACCCCATTA -> ACTATTGAGCAACTACCCCATTAT
GGGAGTGTTAGCAAGCGCCCATGG -> GGAGTGTTAGCAAGCGCCCATGGG
AGCCCAGTTATCCTTTCCTACAAT -> GCCCAGTTATCCTTTCCTACAATC
CCCTCCTTGGCAAACTCGGGCGTT -> CCTCCTTGGCAAACTCGGGCGTTC
CCTACAATCCTGAGCGGGGGTACT -> CTACAATCCTGAGCGGGGGTACTC
GACGTCTCATGCAATCTGCCGTAA -> ACGTCTCATGCAATCTGCCGTAAC
TATTGAGCAACTACCCCATTATTG -> ATTGAGCAACTACCCCATTATTGG
GTTAGGCCCCTTTTCATTTAGCTT -> TTAGGCCCCTTTTCATTTAGCTTT
CGTGTTCTCTTCCAGGAAACTATG -> GTGTTCTCTTCCAGGAAACTATGC
GCAGCCGGACGGCGTCCTCCATAG -> CAGCCGGACGGCGTCCTCCATAGG
ACTTTGCTACTAGCTTCTCTCTTC -> CTTTGCTACTAGCTTCTCTCTTCA
GGCACGCTTCTAACACCCGTGTTC -> GCACGCTTCTAACACCCGTGTTCT
CGTCTTAGACTACGGGAACTAATC -> GTCTTAGACTACGGGAACTAATCC
GTGAATAACACATCAAGGCACACG -> TGAATAACACATCAAGGCACACGC
AACGGCATAGTCAATTGTATCCCG -> ACGGCATAGTCAATTGTATCCCGC
GACCGCCCAGTAGCACTCAATGTC -> ACCGCCCAGTAGCACTCAATGTCG
GTTATCCTTTCCTACAATCCTGAG -> TTATCCTTTCCTACAATCCTGAGC
GGTCCGAGCTAATGTCGCTTCATG -> GTCCGAGCTAATGTCGCTTCATGG
CTGGGATGCTTTCTCGCCGTTTTA -> TGGGATGCTTTCTCGCCGTTTTAA
CTGAGCGGGGGTACTCATAAGTTG -> TGAGCGGGGGTACTCATAAGTTGG
TATGCTTTCCTGTGCGAAGATTCC -> ATGCTTTCCTGTGCGAAGATTCCT
ATGGCCGTTACCAAACTTGCCCGG -> TGGCCGTTACCAAACTTGCCCGGC
CGCTTCATGGTCTGGATTGGTGAA -> GCTTCATGGTCTGGATTGGTGAAT
ACGGATATACGCGATCCTGCCGAA -> CGGATATACGCGATCCTGCCGAAA
ACCGAAGCGATTCCTATTACCTCT -> CCGAAGCGATTCCTATTACCTCTG
GTAAGAAGTGCAGGCGAGTAAAGA -> TAAGAAGTGCAGGCGAGTAAAGAT
GCTTACCTGCATAATTACCGTCTT -> CTTACCTGCATAATTACCGTCTTT
TCCTGCCTTCAGCCCCTGCGGCTT -> CCTGCCTTCAGCCCCTGCGGCTTA
AGCTTTTCTTTTTGTCATGAACGC -> GCTTTTCTTTTTGTCATGAACGCG
ACTACACAGCTATGATCATGGCAG -> CTACACAGCTATGATCATGGCAGT
GTTTCATCTACAGAAAAAAATCTG -> TTTCATCTACAGAAAAAAATCTGT
GGACTCTTAAAACCTGACTTGAGT -> GACTCTTAAAACCTGACTTGAGTG
AAGTCTGTCACCTTACCAAGCAGT -> AGTCTGTCACCTTACCAAGCAGTT
CTTGCATCACGGTAACTGCTTACC -> TTGCATCACGGTAACTGCTTACCT
CAGCCCCTGCGGCTTATAGTGGCA -> AGCCCCTGCGGCTTATAGTGGCAA
TACTGCGCCGTCGGACTGAGGCCT -> ACTGCGCCGTCGGACTGAGGCCTC
TCTTCATCAGTCCGTACGCCCGAC -> CTTCATCAGTCCGTACGCCCGACC
CACTCAGTATGTATTGGCCCCAAG -> ACTCAGTATGTATTGGCCCCAAGC
ACAATGTGTTTTGGTATCCAGACA -> CAATGTGTTTTGGTATCCAGACAT
ATCATCGGCTATTTGGTAAGTTGT -> TCATCGGCTATTTGGTAAGTTGTC
GAATGCATTCAGTATACATCTTAC -> AATGCATTCAGTATACATCTTACT
TACTGAAACCCGGGCAGGCGTCAT -> ACTGAAACCCGGGCAGGCGTCATA
CAATCAGCATTCCGACTACACAGC -> AATCAGCATTCCGACTACACAGCT
AGCACTCAATGTCGGGTATGACCC -> GCACTCAATGTCGGGTATGACCCA
CTGGAGGAAGCGCGCCCTCAATCA -> TGGAGGAAGCGCGCCCTCAATCAG
GCCCGCGAAGCCCTACTAACGGCC -> CCCGCGAAGCCCTACTAACGGCCT
AAGCCAGAACATGAACAAAGCAGG -> AGCCAGAACATGAACAAAGCAGGA
TCTGTCACCTTACCAAGCAGTTAG -> CTGTCACCTTACCAAGCAGTTAGT
ATGAAGTGGCAAATCACTTGCATC -> TGAAGTGGCAAATCACTTGCATCA
CTGGCTAAGGTCCGATAAGGTGCG -> TGGCTAAGGTCCGATAAGGTGCGG
TTAAAACCTGACTTGAGTGTAGGC -> TAAAACCTGACTTGAGTGTAGGCC
CTTTTGCGGAGTGGATTCCCTACC -> TTTTGCGGAGTGGATTCCCTACCG
TCTTACATGGATCAAGTATCTCTG -> CTTACATGGATCAAGTATCTCTGT
GTCAATTGTATCCCGCAAAAATAC -> TCAATTGTATCCCGCAAAAATACC
TGGTATCCAGACATGTGCACTCGG -> GGTATCCAGACATGTGCACTCGGA
TGCCGAAACATCCATGTTGAAAAA -> GCCGAAACATCCATGTTGAAAAAA
GTCCGTACGCCCGACCGAAGCGAT -> TCCGTACGCCCGACCGAAGCGATT
ACGCCCGACCGAAGCGATTCCTAT -> CGCCCGACCGAAGCGATTCCTATT
ACTGCTTACCTGCATAATTACCGT -> CTGCTTACCTGCATAATTACCGTC
GACTGGCTAAGGTCCGATAAGGTG -> ACTGGCTAAGGTCCGATAAGGTGC
CGGACATTAGGCCCCCCGGCTACA -> GGACATTAGGCCCCCCGGCTACAG
GCGAAGATTCCTTAATTCAGACCG -> CGAAGATTCCTTAATTCAGACCGC
CATGTGAAGCCTAGCATACGTTTC -> ATGTGAAGCCTAGCATACGTTTCA
TCTGGATTGGTGAATAACACATCA -> CTGGATTGGTGAATAACACATCAA
CAGACTATTGAGCAACTACCCCAT -> AGACTATTGAGCAACTACCCCATT
ATACTGAAACCCGGGCAGGCGTCA -> TACTGAAACCCGGGCAGGCGTCAT
TGTAGGCCTGTCACTTTGATCAGA -> GTAGGCCTGTCACTTTGATCAGAG
ACCAGCATTGGGTAACTGTTCTAC -> CCAGCATTGGGTAACTGTTCTACG
GGGGACTGGCTAAGGTCCGATAAG -> GGGACTGGCTAAGGTCCGATAAGG
GTTAAGTCTGTCACCTTACCAAGC -> TTAAGTCTGTCACCTTACCAAGCA
GGATATACGCGATCCTGCCGAAAC -> GATATACGCGATCCTGCCGAAACA
CCGCAGTTGGGTATGCTTTCCTGT -> CGCAGTTGGGTATGCTTTCCTGTG
TGTTAAGTCTGTCACCTTACCAAG -> GTTAAGTCTGTCACCTTACCAAGC
GCAGCTCGGAGTGTCTGTTGCTGC -> CAGCTCGGAGTGTCTGTTGCTGCA
GATGCACTTCAGTGGGCCCTGTTG -> ATGCACTTCAGTGGGCCCTGTTGT
GGCAGGCGTCATACCGGGGATACA -> GCAGGCGTCATACCGGGGATACAC
CTGCCTTCAGCCCCTGCGGCTTAT -> TGCCTTCAGCCCCTGCGGCTTATA
CCTCCATAGGAATGCGACGGAGCC -> CTCCATAGGAATGCGACGGAGCCC
CCCCCCGGCTACAGTGGGATTCAC -> CCCCCGGCTACAGTGGGATTCACG
TTCATTTAGCTTTTCTTTTTGTCA -> TCATTTAGCTTTTCTTTTTGTCAT
GTTACTCACATCGTGGAGTGGACT -> TTACTCACATCGTGGAGTGGACTC
ACCAAACTTGCCCGGCCCTCCTTG -> CCAAACTTGCCCGGCCCTCCTTGG
CTTAGACTACGGGAACTAATCCTG -> TTAGACTACGGGAACTAATCCTGC
GCAATCTGCCGTAACAAATCTTTT -> CAATCTGCCGTAACAAATCTTTTT
ATCACTTGCATCACGGTAACTGCT -> TCACTTGCATCACGGTAACTGCTT
CCCTCATCGGCAGATTGCAAGTCA -> CCTCATCGGCAGATTGCAAGTCAT
GTGTAAGAAGTGCAGGCGAGTAAA -> TGTAAGAAGTGCAGGCGAGTAAAG
CACTTTGATCAGAGTAAGATGGGC -> ACTTTGATCAGAGTAAGATGGGCA
TGGATTCCCTACCGGGACCGGGAC -> GGATTCCCTACCGGGACCGGGACT
CATAACACTCTCCCGGACATTAGG -> ATAACACTCTCCCGGACATTAGGC
CGCCGTCGGACTGAGGCCTCCATT -> GCCGTCGGACTGAGGCCTCCATTC
GAAAAAAATGAGCGTGTTACTCAC -> AAAAAAATGAGCGTGTTACTCACA
ACCGGCGGTCCGAGCTAATGTCGC -> CCGGCGGTCCGAGCTAATGTCGCT
CTAGGCAGCTCGGAGTGTCTGTTG -> TAGGCAGCTCGGAGTGTCTGTTGC
TGTAAGAAAAGTTCAGAGGCGGCG -> GTAAGAAAAGTTCAGAGGCGGCGG
AAAAAAATCTGTGCATAACACTCT -> AAAAAATCTGTGCATAACACTCTC
CGCTTCGGGGACTGGCTAAGGTCC -> GCTTCGGGGACTGGCTAAGGTCCG
GTCCTGATAGTACGGAAAGAAGTT -> TCCTGATAGTACGGAAAGAAGTTG
TAGGCCCCCCGGCTACAGTGGGAT -> AGGCCCCCCGGCTACAGTGGGATT
AGGCCCCCCGGCTACAGTGGGATT -> GGCCCCCCGGCTACAGTGGGATTC
GTGACCACGTCATTGCGGCCGCAG -> TGACCACGTCATTGCGGCCGCAGT
ATCTTTTTAAGCCAGAACATGAAC -> TCTTTTTAAGCCAGAACATGAACA
ATACCCTGACGAAACACCATTTAG -> TACCCTGACGAAACACCATTTAGG
AAGATACTTATGTCTTACATGGAT -> AGATACTTATGTCTTACATGGATC
AGGCGAGTAAAGATGGCCGTTACC -> GGCGAGTAAAGATGGCCGTTACCA
TGTGCATAACACTCTCCCGGACAT -> GTGCATAACACTCTCCCGGACATT
TTCAGTGGGCCCTGTTGTAGGACT -> TCAGTGGGCCCTGTTGTAGGACTG
GTATATCCCCCCTCATGAGTCACC -> TATATCCCCCCTCATGAGTCACCA
CCAGGAAACTATGCCAGACGGACG -> CAGGAAACTATGCCAGACGGACGT
TACACCTGAGATGCGCCCGAACGC -> ACACCTGAGATGCGCCCGAACGCC
ACGAATGAAGTGGCAAATCACTTG -> CGAATGAAGTGGCAAATCACTTGC
ATCTGGGATGCTTTCTCGCCGTTT -> TCTGGGATGCTTTCTCGCCGTTTT
GGGGTTAGATAATGTCCATGGTCT -> GGGTTAGATAATGTCCATGGTCTC
CTATCACAACGGCATAGTCAATTG -> TATCACAACGGCATAGTCAATTGT
CAGACATGTGCACTCGGACCGAGC -> AGACATGTGCACTCGGACCGAGCG
CTTCCGTGTTCTCGGAGTAGCTAG -> TTCCGTGTTCTCGGAGTAGCTAGT
CAAGTCATAGAGCCACATACTGAA -> AAGTCATAGAGCCACATACTGAAA
CACGTCATTGCGGCCGCAGTTGGG -> ACGTCATTGCGGCCGCAGTTGGGT
AGTGGGCCCTGTTGTAGGACTGTA -> GTGGGCCCTGTTGTAGGACTGTAT
GCGAAGCCCTACTAACGGCCTCAG -> CGAAGCCCTACTAACGGCCTCAGG
TGCTGCAGCCGGACGGCGTCCTCC -> GCTGCAGCCGGACGGCGTCCTCCA
GGTAGTCTAGGCAGCTCGGAGTGT -> GTAGTCTAGGCAGCTCGGAGTGTC
GATAGTACGGAAAGAAGTTGTCGA -> ATAGTACGGAAAGAAGTTGTCGAG
GCCAACCAAACGATGAGCTGCAGG -> CCAACCAAACGATGAGCTGCAGGG
TGCTGACGAACGAATGAAGTGGCA -> GCTGACGAACGAATGAAGTGGCAA
AGCGGGGGTACTCATAAGTTGGCA -> GCGGGGGTACTCATAAGTTGGCAC
CCTCTGTCAGACACACCGATCCCC -> CTCTGTCAGACACACCGATCCCCT
GTCGCCGCTTAGAATGCATTCAGT -> TCGCCGCTTAGAATGCATTCAGTA
ATCCTGCCGAAACATCCATGTTGA -> TCCTGCCGAAACATCCATGTTGAA
CCATGGGTCACGTCGGGCCACCGG -> CATGGGTCACGTCGGGCCACCGGG